44444444444444444444444444444444444444444444444442244444422222222222222444444224444444444444444444444444444444444444444444444444
44444444444444444444444444444444444444444442444444444442222222222222222224444444444224444444444444444444444444444444444444444455
44444444444444444444444444444444444444444444444442244444222222222222222244444224444444444444444444444444444444444444444444444444
44444444444444444444444444444444444444444442244444444442222222222222222224444444444224444444444444444444444444444444444444444444
44444444444444444444444444444444444444444444444442244444222222222222222244444444444444444444444444444444444444444444444444444444
44444444444444444444444444444444444444444442244444444442222222222222222224444444444224444444444444444444444444444444444444444444
44444444444444444444444444444444444444444424444444444233222222222222222233244444444442444444444444444444444444444444444444444444
44444444444444444444444444444444444444444444444244444422222222222222222222444444244444444444444444444444444444444444444444444444
44444444444444444444444444444444444444444444442444444222222222222222222222444444422444444444444444444444444444444444444444444444
44444444444444444444444444444444444444444444444444444442222222222222222224444444444444444444444444444444444444444444444444444444
44444444444444444444444444444444444444444444444442244444442222222222224444444224444444444444444444444444444444444444444444444444
44444444444444444444444444444444444444444444444222224444444222222222244444442222244444444444444444444444444444444444444444444444
44444444444444444444444444444444444444444444444422222244444442222244444444222222444444444444444444444444444444444444444444444444
44444444444444444444444224422444444444444444444222222222444444422444444422200222244444444444444444422442244444444444444444444444
44444444444444444444422222222224444444444444444422200000224444444444442200000222444444444444444442222222222444444444444444444444
44444444444444444442222222222222244444444444444222200000022244444444222000000222244444444444444222222222222224444444444444444444
44444444444444444422222222222222222444444444444422200000000222444422200000000222444444444444442222222222222222244444444444444444
44444444444444444422222222222222224444444444444422200000000002222220000000000222444444444444442222222222222222444444444444444444
44444444444444444222222222222222222444444444444442222000000000020000000000022224444444444444422222222222222222244444444444444444
44444444444444444422222222222222224444444444444444422220000000000000000002222444444444444444442222222222222222444444444444444444
44444444444444444222222222222222222444444444444444444222200000000000000222244444444444444444422222222222222222244444444444444444
44444444444444444422222222222222224444444444444444444442222000000000022224444444444444444444442222222222222222444444444444444444
44444444444444444222222222222222222444444444444444444444422200000002222444444444444444444444422222222222222222244444444444444444
44444444444444422222222222222222244444444444444444444444442220000002224444444444444444444444444222222222222222222444444444444444
44444444444442222222222222222224444444444444444444444444422220022002222444444444444444444444444442222222222222222224444444444444
44444444444444222222222222222244444444444444444444444444443222222222234444444444444444444444444444222222222222222244444444444444
44444444444442222222222222222224444444444444444444444444423222222222232444444444444444444444444442222222222222222224444444444444
44444444444444222422222222222222244444444444444444444442222223222232222244444444444444444444444222222222222222422244444444444444
44444444444442244422222222222222222444444444444444444222222222222222222222444444444444444444422222222222222222444244444444444444
44444444444444444444422222222222222224444444444444422222222222222222222222222444444444444442222222222222222444244444444444444444
44444444444444424444222222222222222222244444444442222222222222222222222222222224444444444222222222222222222244444444444444444444
44444444444444444444222222222222222222222444444222222222222222222222222222222222244444422222222222222222222244444444444444444444
44444444444444444444442222222222222222222224422222222222222222222222222222222222222442222222222222222222224444444444444444444444
44444444444444444444444222222222222222222222222222222222222222222222222222222222222222222222222222222222244444444444444444444444
44444444444444444444444442222222222222222222222222222222222222222222222222222222222222222222222222222224444444444444444444444444
44444444444444444444444444422222222222222222222222222222222222222222222222222222222222222222222222222444444444444444444444444444
44444444444444444444444444442222222222222222222222222222222222222222222222222222222222222222222222224444444444444444444444444444
44444444444444444444444444422222222222222222222222222222222222222222222222222222222222222222222222222444444444444444444444444444
44444444444444444444444444442222222222222222222222222222222222222222222222222222222222222222222222224444444444444444444444444444
44444444444444444444444444422222222222222222222222222222222222222222222222222222222222222222222222222444444444444444444444444444
44444444444444444444444444443322222222222222222222222222222222222222222222222222222222222222222222334444444444444444444444444444
44444444444444444444444444422222222222222222222222222222222222222222222222222222222222222222222222222444444444444444444444444444
44444444444444444444444444443322222222222222222222222222222222222222222222222222222222222222222222334444444444444444444444444444
44422444444444444444444444422222222222222222222222222222222222222222222222222222222222222222222222222444444444444444444444422444
44444444444444444444444442222222222222222222222222222222222222222222222222222222222222222222222222222224444444444444444444444444
44444444444444444444444222222222222222222222222222222222222222222222222222222222222222222222222222222222244444444444444444444444
22222222224444444444422222222222222222222222222222222222222222222222222222222222222222222222222222222222222444444444442222222222
00200020022244422442222222222222222222222222222222222222222222222222222222222222222222222222222222222222222224422444220022200220
00000000000222222222222222222222222222222222222222222222222222222222222222222222222222222222222222222222222222222222200000000000
00000000000002222222222222222222222222222222222222222222222222222222222222222222222222222222222222222222222222222222000000000000
00000002200002222222222222222222222222222222222222222222222222244222222222222222222222222222222222222222222222222220000220000000
02200222222002222222222222222222222222222222222222222222244224444442244222222222222222222222222222222222222222222220022222200220
22222224442222222222222222222222222222222222222222222222244444444444444222222222222222222222222222222222222222222222222442222222
44424444444422222222222222222222222222222222222222222222224444222244442222222222222222222222222222222222222222222222244444424442
44444444444442222222222222222222222222222222222222222222222222222222222222222222222222222222222222222222222222222244444444444444
44444442244444422222222222222222222222222222222222222222222222222222222222222222222222222222222222222222222222222444444224444444
42244222222444444222222222222222222222222222222222222222222222222222222222222222222222222222222222222222222222244444422222244224
33222222222224444442222222222222222222222222244222222222222222222222222222222222244222222222222222222222222224444442222222222233
22222222222222244444222222222222222222222222244442222222222222222222222222222224444222222222222222222222222244444222222222222222
22222222222222222442222222222222222222222222224442222222222222222222222222222224442222222222222222222222222224422222222222222222
22222222222222224444222222222222222222222222332442222222222222222222222222222224422222222222222222222222222244442222222222222222
22222222222222222442222222222222222222222222244442222222222222222222222222222224444222222222222222222222222224422222222222222222
22222222222222222222222222222222222222222222244422222222222222222222222222222222444222222222222222222222222222222222222222222222
22222222222222222222222222222222222222222222244222222222222222222222222222222222244222222222222222222222222222222222222222222222
22222222222222222222222222222222222222222222244233222222222222222222222222222222244222222222222222222222222222222222222222222222
22222222222222222222222222222222222222222222244222222222222222222222222222222233244222222222222222222222222222222222222222222222
22222222222222222222222222222222222222222222244442222222222222222222222222222224444222222222222222222222222222222222222222222222
22222222222222222442222222222222222222222222224442222222222222222222222222222224442222222222222222222222222224422222222222222222
22222222222222224444222222222222222222222222222442222222222222222222222222222224423322222222222222222222222244442222222222222222
22222222222222222442222222222222222222222222244442222222222222222222222222222224444222222222222222222222222224422222222222222222
22222222222222244444222222222222222222222222244422222222222222222222222222222222444222222222222222222222222244444222222222222222
33222222222224444442222222222222222222222222222222222222222222222222222222222222222222222222222222222222222224444442222222222233
42444222222444444222222222222222222222222222222222222222222222222222222222222222222222222222222222222222222222244444422222244224
44444442244444422222222222222222222222222222222222222222222222222222222222222222222222222222222222222222222222222444444244444444
44444444444442222222222222222222222222222222222222222222222442222224422222222222222222222222222222222222222222222224444444444444
44444444444422222222222222222222222222222222222222222222244444422444444222222222222222222222222222222222222222222222444444444444
22222244442222222222222222222222222222222222222222222222244444444444444222222222222222222222222222222222222222222222224444222222
00200222222002222222222222222222222222222222222222222222222222444422222222222222222222222222222222222222222222222220022222000220
00000002200002222222222222222222222222222222222222222222222222222222222222222222222222222222222222222222222222222220000020000000
00000000000002222222222222222222222222222222222222222222222222222222222222222222222222222222222222222222222222222220000000000000
00000000000222333322222222222222222222222222222222222222222222222222222222222222222222222222222222222222222222333322200000000000
02200220022244444444222222222222222222222222222222222222222222222222222222222222222222222222222222222222222224442444222002200220
22222222224444444444422222222222222222222222222222222222222222222222222222222222222222222222222222222222222444444444442222222222
44422444444444444444444222222222222222222222222222222222222222222222222222222222222222222222222222222222444444444444444424422442
44444444444444444444444444222222222222222222222222222222222222222222222222222222222222222222222222222244444444444444444444444444
44422444444444444444444444422222222222222222222222222222222222222222222222222222222222222222222222222444444444444444444444424444
44444444444444444444444444443322222222222222222222222222222222222222222222222222222222222222222222334444444444444444444444444444
44444444444444444444444444422222222222222222222222222222222222222222222222222222222222222222222222222444444444444444444444444444
44444444444444444444444444443322222222222222222222222222222222222222222222222222222222222222222222334444444444444444444444444444
44444444444444444444444444422222222222222222222222222222222222222222222222222222222222222222222222222444444444444444444444444444
44444444444444444444444444442222222222222222222222222222222222222222222222222222222222222222222222224444444444444444444444444444
44444444444444444444444444422222222222222222222222222222222222222222222222222222222222222222222222222444444444444444444444444444
44444444444444444444444444442222222222222222222222222222222222222222222222222222222222222222222222224444444444444444444444444444
44444444444444444444444444422222222222222222222222222222222222222222222222222222222222222222222222222444444444444444444444444444
44444444444444444444444442222222222222222222222222222222222222222222222222222222222222222222222222222224444444444444444444444444
44444444444444444444444222222222222222222222222222222222222222222222222222222222222222222222222222222222244444444444444444444444
44444444444444444444422222222222222222222244442222222222222222222222222222222222224442222222222222222222222444444444444444444444
44444444444444444444222222222222222222222444444222222222222222222222222222222222244444422222222222222222222244444444444444444444
44444444444444444444222222222222222222244444444442222222222222222222222222222224444444444222222222222222222244444444444444444444
44444444444444244422222222222222222244444444444444422222222222222222222222222444444444444442222222222222222222444244444444444444
44444444444442222222222222222222222444444444444444444222222223222232222222444444444444444444422222222222222222222244444444444444
44444444444444222222222222222222244444444444444444444444222223222232222224444444444444444444444222222222222222222244444444444444
44444444444442222222222222222224444444444444444444444444423222222222232444444444444444444444444442222222222222222224444444444444
44444444444444222222222222222244444444444444444444444444442222222222224444444444444444444444444444222222222222222244444444444444
44444444444444222222222222222224444444444444444444444444422220022002222444444444444444444444444442222222222222222244444444444444
44444444444444422222222222222222244444444444444444444444442220000002224444444444444444444444444222222222222222222444444444444444
44444444444444444222222222222222222444444444444444444444442220000002224444444444444444444444442222222222222222244444444444444444
44444444444444444422222222222222224444444444444444444444222000000000002244444444444444444444442222222222222222444444444444444444
44444444444444444222222222222222222444444444444444444422200000000000000222444444444444444444422222222222222222244444444444444444
44444444444444444422222222222222224444444444444444442220000000000000000002224444444444444444442222222222222222444444444444444444
44444444444444444222222222222222222444444444444444222000000000022000000000002244444444444444422222222222222222244444444444444444
44444444444444444422222222222222224444444444444222200000000002222220000000000222244444444444442222222222222222444444444444444444
44444444444444444422222222222222224444444444444422200000000222244222200000000222444444444444422222222222222222444444444444444444
44444444444444444442222222222222244444444444444222200000022244444442222000000222244444444444444222222222222224444444444444444444
44444444444444444444442222222244444444444444444422200002222444444444422220000222444444444444444444222222222444444444444444444444
44444444444444444444444224424444444444444444444222200222244444422444444222200222244444444444444444422444244444444444444444444444
44444444444444444444444444444444444444444444444422222224444442222224444442222222444444444444444444444444444444444444444444444444
44444444444444444444444444444444444444444444444222222444444222222222244444422222244444444444444444444444444444444444444444444444
44444444444444444444444444444444444444444444444442444444422222222222222444444224444444444444444444444444444444444444444444444444
44444444444444444444444444444444444444444444444444444442222222222222222224444444444444444444444444444444444444444444444444444444
44444444444444444444444444444444444444444444422444444233222222222222222233244444424444444444444444444444444444444444444444444444
44444444444444444444444444444444444444444444444444444422222222222222222222444444444444444444444444444444444444444444444444444444
44444444444444444444444444444444444444444424444444444222222222222222222222244444444442444444444444444444444444444444444444444444
44444444444444444444444444444444444444444442244444444442222222222222222224444444444224444444444444444444444444444444444444444444
44444444444444444444444444444444444444444444444442444444222222222222222244444244444444444444444444444444444444444444444444444444
44444444444444444444444444444444444444444442244444444442222222222222222224444444444224444444444444444444444444444444444444444444
44444444444444444444444444444444444444444444444442244444222222222222222244444224444444444444444444444444444444444444444444444444
55554444444444444444444444444444444444444442444444444442222222222222222224444444444224444444444444444444444444444444444444444455
