00000000000000000000000000000000000000001111111111111111110000222200001111111111111111120000000000000000000000000000000000001111
00000002222000000000000000000000000000002111111111111111000220222202200011111111111111120000000000000000000000000000000000001111
00000002222000000000000000000000000000001111111111111111000000000000000011111111111111110000000000000000000000000000022220000000
00220000000000000000000000000000000000002111111111111111022000000000022011111111111111120000000000000000000000000000022220000000
00000000000000000000000000000000000000001111111111111111000000000000000011111111111111110000000000000000000000000000000000002200
00220000000000000000000000000000000000111111111111111111022000000000022011111111111111111100000000000000000000000000000000000220
02200000000000000000000000000000000000211111111111111111000000000000000011111111111111111200000000000000000000000000000000002200
00220000000000000000000000000000000000002111111111111100000000000000000000111111111111120000000000000000000000000000000000000220
00220000000000000000000000000000000000000021111111111100000000000000000000111111111112000000000000000000000000000000000000000220
02200000000000000000000000000000000000000000211111111111000000000000000011111111111100000000000000000000000000000000000000002200
00220000000000000000000000000000000000000000211111111111110000022000001111111111111100000000000000000000000000000000000000000000
00220000000000000000001111111100000000000000211111111111111100000000111111111111111200000000000000111111110000000000000000002200
00022000000000000000111111111111000000000000111111111111111111000011111111111111111100000000000011111111111100000000000000002200
00000000000000000011111111111111110000000000211111111111111111111111111111111111111200000000001111111111111111000000000000022000
00000000000000001111110000000011111100000000211111111111111111111111111111111111111200000000111111000000001111110000000000000000
00000000000000111111000000000000111112000000211111111111111111111111111111111111111200000011111100000000000011111200000000000000
00000000000000211100022022220000001112000000211111111111111111111111111111111111111100000021110000000222222000111200000000000000
00000000000000211100220220022000001111000000211111111111111111111111111111111111111200000021110000022022002200111200000000000000
00000000000000211100000000002200001112000000002111111111111111111111111111111111120000000021110000220000000000111200000000000000
00000000000000211100000000002200001111000000000021111111111111111111111111111111000000000011110000220000000000111100000000000000
00000000000000211100000000000000001112000000000000111111111111111111111111111100000000000021110000000000000000111200000000000000
00000000000000111100000000000000001112000000000000001111111111111111111111110000000000000011110000000000000000111100000000000000
00000000000011111100000000002222001112000000000000000011111111111111111111000000000000000021110022220000000000111111000000000000
00000000001111110000000000002222111100000000000000000021111111111111111112000000000000000000211122220000000000001111110000000000
00000000002111000000000000000011110000000000000000000021111111111111111112000000000000000000001111000000000000000011120000000000
00000000001111000000000000000011110000000000000000002111111111111111111111120000000000000000001111000000000000000011110000000000
00000000002111000000000000000011111100000000000000001111111121122212111111110000000000000000111111000000000000000011120000000000
00000000001111001122000000000000111111000000000000111111222211222211222211111100000000000011111100000000000022110011110000000000
00000000002111111222210000000000001111110000000011111122222222222222222211111111000000001111110000000000001222211111120000000000
00000000000011122221110000000000000011111100001111112222222222222222222222221111110000111111000000000000001112222112000000000000
00000000000000222111120000000000000000111111111111222222222222222222222222222211111111111100000000000000002111122200000000000000
00000000000000002111000000000000000000001111111122222222222222222222222222222222111111110000000000000000000011120000000000000000
00000000000000000021110000000000000000000011111222222222222222222222222222222222121111000000000000000000001112000000000000000000
00000000000000000000211100000000000000000000222222222222222222222222222222222222222200000000000000000000111200000000000000000000
00000000000000000000001111000000000000000000222222222222222222222222222222222222222200000000000000000011110000000000000000000000
00000000000000000000000021110000000000000000222222222222222222222222222222222222222200000000000000001112000000000000000000000000
00000000000000000000000021110000000000000000222222222222222222222222222222222222222200000000000000001112000000000000000000000000
00000000000000000000000021110000000000000000222222222222222222222222222222222222222200000000000000001112000000000000000000000000
00000000000000000000000011110000000000000000222222222222222222222222222222222222222200000000000000001111000000000000000000000000
11000000000000000000000021111100000000000000222222222222222222112222222222222222222200000000000000111112000000000000000000000011
11120000000000000000000021111100000000000000222222222222222222222222222222222222222200000000000000111111000000000000000000001111
11111100000000000000000021111100000000000000222222222222222222222222222222222222222200000000000000111112000000000000000000111111
11111111000000000000000011111122222222222222222222222222222222222222222222222222222222222222222222111111000000000000000021111111
11111111110002200220221111111122222222222222222222222222222222222222222222222222222222222222222222211111112202200220001111111111
11111111111100220022111111222222222222222222222222222222222222222222222222222222222222222222222222222211111122002200111111111111
11111111111111111111111122222222222222222222222222222222222222222222222222222222222222222222222222222222111111111111111111111111
11111111111111111111112222222222222222222222222222222222222222222222222222222222222222222222222222222222221111111111111111111111
11111111111111111111222222222222222222222222222222222222222222222222222222222222222222222222222222222222222211111111111111111111
11111111111111112222222222222222222222222222222222222222222222222222222222222222222222222222222222222222222222221111111111111111
11111111111111112222222222222222222222222222222222222222222222222222222222222222222222222222222222222222222222221111111111111111
11111111111111112222222222222222222222222222222200000000222221111122222200000000222222222222222222222222222222221111111111111111
11111111111111112222222222222222222222222222222200000000111111211211111100000000222222222222222222222222222222221111111111111111
11111111111111222222222222222222222222222222222200000000111221111112211100000000222222222222222222222222222222222211111111111111
11111111111112222222222222222222222222222222222200000000111111111111111100000000222222222222222222222222222222222221111111111111
11111111111111222222222222222222222222222222222200000000001111000011110000000000222222222222222222222222222222222211111111111111
11111111111111112222222222222222222222222222222200000000000000000000000000000000222222222222222222222222222222221111111111111111
11111100001111111122222222222222222222222222222200000000000000000000000000000000222222222222222222222222222222111111110000111111
11000000000011111111222222222222222222222222111100000000000000000000000000000000111122222222222222222222222211111111000000000011
00000220000000111111222222222222222222222222111211000000000000222200000000000011211122222222222222222222222211111100000022000000
00022022000000001111222222222222222211222222111111000000002200222200220000000011111122222211222222222222222211110000002202200000
00220000000000001111222222222222222222222222111111000000000000000000000000000011111222222222222222222222222211110000000000002200
00000000000000001111222222222222222222222222112111000000000000000000000000000011121122222222222222222222222211110000000000000000
00000000000000000000222222222222222222222222111111000000220000000000002200000011111122222222222222222222222200000000000000000000
22220000000000000000222222222222222222222222111111000000000000000000000000000000111122222222222222222222222200000000000000002222
22220000000000000000222222222222222222222222111111000000000000000000000000000011111122222222222222222222222200000000000000002222
00000000000000000000222222222222222222222222111122000000000000000000000000000011111122222222222222222222222200000000000000000000
00000000000000000000222222222222222222222222111211000000220000000000002200000011211122222222222222222222222200000000000000000000
00220000000000001111222222222222222222222222111111000000000000000000000000000011111122222222222222222222222211110000000000002200
00000000000000001111222222222222222211222222211111000000000000000000000000000011111122222211222222222222222211110000000000000000
00022220000000001111222222222222222222222222112111000000002200222200220000000011121122222222222222222222222211110000000022022000
00000022000000111111222222222222222222222222111111000000000000222200000000000011111122222222222222222222222211111100000002200000
11000000000011111111222222222222222222222222111100000000000000000000000000000000111122222222222222222222222211111111000000000011
11111100001111111122222222222222222222222222222200000000000000000000000000000000222222222222222222222222222222111111110000111111
11111111111111112222222222222222222222222222222200000000000000000000000000000000222222222222222222222222222222221111111111111111
11111111111111112222222222222222222222222222222200000000001111002111110000000000222222222222222222222222222222221111111111111111
11111111111111112222222222222222222222222222222200000000112112111121121100000000222222222222222222222222222222221111111111111111
11111111111111112222222222222222222222222222222200000000111111122111111100000000222222222222222222222222222222221111111111111111
11111111111111112222222222222222222222222222222200000000111111111111111100000000222222222222222222222222222222221111111111111111
11111111111111112222222222222222222222222222222222222222222222111122222222222222222222222222222222222222222222221111111111111111
11111111111111112222222222222222222222222222222222222222222222222222222222222222222222222222222222222222222222221111111111111111
11111111111111111121222222222222222222222222222222222222222222222222222222222222222222222222222222222222222212111111111111111111
11111111111111111111122222222222222222222222222222222222222222222222222222222222222222222222222222222222221211111111111111111111
11111111111112211221111222222222222222222222222222222222222222222222222222222222222222222222222222222222111111211121111111111111
11111111111100220022111122222222222222222222222222222222222222222222222222222222222222222222222222222222111222002200211111111111
11111111110002200220222111222222222222222222222222222222222222222222222222222222222222222222222222002211122202200220002111111111
11111112000000000000000021111122222222122222222222222222222222222222222222222222222222222222222222111112000000000000000021111111
11111100000000000000000011111100000000000000222222222222222222222222222222222222222200000000000000111112000000000000000000211111
11120000000000000000000021111100000000000000222222222222222222222222222222222222222200000000000000111112000000000000000000002111
12000000000000000000000021111100000000000000222222222222222222221122222222222222222200000000000000111111000000000000000000000011
00000000000000000000000021111200000000000000222222222222222222222222222222222222222200000000000000211112000000000000000000000000
00000000000000000000000011110000000000000000222222222222222222222222222222222222222200000000000000001111000000000000000000000000
00000000000000000000000021110000000000000000222222222222222222222222222222222222222200000000000000001112000000000000000000000000
00000000000000000000000011110000000000000000222222222222222222222222222222222222222200000000000000001111000000000000000000000000
00000000000000000000001111110000000000000000222222222222222222222222222222222222222200000000000000001111110000000000000000000000
00000000000000000000111111000000000000000000222222222222222222222222222222222222222200000000000000000011111100000000000000000000
00000000000000000011111100000000000000000000222222222222222222222222222222222222222200000000000000000000111111000000000000000000
00000000000000002111110000000000000000000011112222222222222222222222222222222222221111000000000000000000001111120000000000000000
00000000000000222211120000000000000000001112211122222222222222222222222222222222111211110000000000000000002111222200000000000000
00000000000011112221110000000000000000111100001111122222222222222222222222222211110000111100000000000000001112221111000000000000
00000000002111111222220000000000000011110000000011112222222222222222222222221111000000001111000000000000002222211111120000000000
00000000002111111122000000000000001112000000000000111122222211222211222212111100000000000021110000000000000022111111120000000000
00000000001111000000000000000000111100000000000000001111221211122211212211120000000000000000111100000000000000000011110000000000
00000000002111000000000000000011110000000000000000000021111111111111111111000000000000000000001111000000000000000011120000000000
00000000002111000000000000000011110000000000000000000021111111111111111111000000000000000000001111000000000000000011110000000000
00000000002111000000000000000011111100000000000000000021111111111111111112000000000000000000111111000000000000000011120000000000
00000000000011110000000000002222111112000000000000000011111111111111111111000000000000000011111122220000000000001111000000000000
00000000000000111100000000002222001112000000000000001111111111111111111111110000000000000021110022220000000000111100000000000000
00000000000000111100000000000000001111000000000000111111111111111111111111111100000000000011110000000000000000111100000000000000
00000000000000211100000000000000001112000000000011111111111111111111111111111111000000000021110000000000000000111200000000000000
00000000000000111100000000002200001111000000001111111111111111111111111111111111110000000021110000220000000000111200000000000000
00000000000000211100000000002200001112000000211111111111111111111111111111111111111200000021110000220000000000111200000000000000
00000000000000211100220220022000001111000000211111111111111111111111111111111111111200000021110000022002202200111100000000000000
00000000000000211100002222220000001112000000111111111111111111111111111111111111111200000021110000002222220000111200000000000000
00000002222000002111000000000000111200000000211111111111111111111111111111111111111200000000111100000000000011110000000000000000
00000002222000000011110000000011110000000000211111111111111111111111111111111111111200000000001111000000001111000000022220000000
00220000000000000000211111111112000000000000211111111111111111111111111111111111111200000000000021111111111100000000022220000000
00220000000000000000001111111200000000000000111111111111111111022011111111111111111200000000000000111121110000000000000000000000
02200000000000000000000000000000000000000000211111111111111100000000111111111111111200000000000000000000000000000000000000002200
02200000000000000000000000000000000000000000111111111111110000000000001111111111111100000000000000000000000000000000000000000220
00000000000000000000000000000000000000000021111111111111000000000000000011111111111112000000000000000000000000000000000000000220
02200000000000000000000000000000000000001111111111111111000000000000000011111111111111110000000000000000000000000000000000002200
00220000000000000000000000000000000000211111111111111100000000000000000000111111111111111100000000000000000000000000000000000220
02200000000000000000000000000000000000211111111111111100022000000000022000111111111111111200000000000000000000000000000000000000
00220000000000000000000000000000000000001111111111111111000000000000000011111111111111110000000000000000000000000000000000002200
00022000000000000000000000000000000000001111111111111111022000000000022011111111111111120000000000000000000000000000000000002200
00000000000000000000000000000000000000002111111111111111000000222200000011111111111111120000000000000000000000000000000002222000
11111000000000000000000000000000000000001111111111111111000220222202200011111111111111110000000000000000000000000000000000011111
11111111111111111111111111111111111111111111111111111111111111111111111111111111111111111111111111111111111111111111111111111111
