00000000000000000000000000000000000000000000000022222200000000000000000000000000000000000000222222222222222244444422440000000111
00000000000000000000000000000000000000000000000002220000000000000000000000000000000000000002222222222222222224444444200000001111
00000000000000000000000000000000000000000000000002200000000000000000000000000000000000000002222222222222222224444444224000000111
00000000000000000000000000000000000000000000000002200000000000000000000000000000000000000000022222222222222222444444224400000110
00000000000000000000000000000002000000000000000022200000000000000000000000000000000000000200022222222222222222244444440000000100
00000000000000000000002000000222200000000000000222200000000000000000000000000000000000002220222222222222222222244444400000000000
00000000000000000000022200002222220000000000002222000000000000000000000000000000000000222222222222222222222222244444224000000000
00000000000000000000222222222222222000000000000222000000000000000000000000000000000000222222222222222222222222244444224400000000
00000000000020000002222222222222222220000000000022200000000000000000000000000000000000022222222222222222222222244444440000000000
00000000000222200222222222222222222222200000000022220000000000000000000000000000000000022222222222222222222222244444400000000000
00000000002222222222222222222222222222220000000002220000000000000000000000000000000000022222222222222222222222244442240000000000
00000000002222222222222222222222222222222000000000222000000000000000000000000000000000022222222222222222222224440000000000000000
00000000022222222222222222222222222222222200000000222000000000000000000000000000000000222222222222222222222224400000000000000000
00000000222220022222222222222222222222222000000000022000000000000000000000000000000000002222233222222222222222444000000000000000
00000000022222222222222222222222222222222200000000022200000000000000000000000000000000000022233222222224444422244400000000000000
00000000002222222222222222222222222222222200000000022200000000000000000000000000000000000222222222222224444444440000000000000000
00000000000022222222222222222222222222222220000000002220000000000000000000000000000000000222222222222224444444400000000000000000
00000000000022222222222222222222222222222222000000002220000000000000000000000000000000000222222222222224444444440000000000000000
00000000000022222222222222222222222222222220000000000222000000000000000000000000000000002222222222222224444444200000000000000000
02000000022222222222222222222222222222222220000000000022200000000000000000000000000000022222222222222224444444440000000000000000
22222002222222222222222222222222222222222220000000000022200000000000000000000000000200222222222222222222444444000000000000000000
22222222222222202222222222222222222222222222000000001102220002200000000002000000022220022222222222222222224440000000000000000000
22222222202222222222222222222222222222222200000000001102222002222002200022200002222220222222222222222222222444000000000000000000
22222222222022222222222222222222222222222000000000000222222222222222200222200222222222222222222222222222222440000000000000000000
22222222222222222222222222222222222222220000000000002222222222222222220222222222222222222222222222222222222244400000000000000000
22222222222222222222222222222222222200000000000000022200002222222222200222222222022222222222222222222222222222444004400000000000
44444222222222222222222222222222220000000000000000020000000000000222000020222000022222222222222222222222222222224444444000000000
44444222222222222222022222222000000000000000000000000000000000000000000000000000222222222222222222222222222222222222244400000000
22222222222222222222222222222000000000000000000000000000000000000000000000000000002222222222222222222222222222222222244000000000
22222222222222222222222222222000000000000000000000000000000000000000000000000000000222222222222222222222222222222223224440000000
22222222222222222222200222222200000000000000000000000000000000000000000000000000000022222222222222222222222222222222222444400440
22222222222222222332222222220000000000000000000000000000000000000000000000000000000000002222222222222222222222222222222444444444
22222222222222222332222222000000000000000000000000000000000000000000000000000000000000000222222222222222222222222222222222222222
22222222222222222222222202220000000000000000000000000000000000000000000000000000000000000222222222222222222222222222222222222222
22222222222222222222222222222200000000000000000000000000000000000000000000000000000000000022222222222222222222222222223222222222
22222222222222222222222222222222000000000000000000000000000000000000000000000000000000000002222222222222222222222222222222222222
22222222222222222222222222222222220000000000000000000000000000000000000000000000000000000022222222222222222222222222222222222222
22222242222222222222222222222222222200000000000000000000000000000000000000000000000000000000222222222222222222222222222222222222
42444442222222222222222222222222222222000000000000000000000000000000000000000000000000000000022222222222222222222222222222222222
44444442222222222222222222222222222222000000000000000000000000000000000000000000000000000020022222222222222222222222222222222222
44444444422222222222222222222222222220000000000000000000000000000000000000000000000000000222222200222222222222222222222222222222
44444444422222222222222222222222222220000000000000000000000000000000000000000000000000002222222220022222222222222222222222222222
44444422422222222222222222222222222220000000000000000000000000000000000000000000000000002222222222002222222222222222222222222222
44444444242222222222222222222222222220000000000000000000000000000000000000000000000000222222222200000022222222223322222222222222
44444444444422222222222222222222222222000000000000000000000000000000000000000000000002222222222000000000222222223322222222222222
44444444444444222222222222222222222220000000000000000000000000000000000000000000000022222222222200000000002222222222222222222222
44444444444444442222222222222222222200000000000000000000000000000000000000000000000002222222222000000000000022222222222222222222
44444444444444444422222222222222222200000000000000000000000000000000000000000000000022222222222200000000000000022222222222222222
44444444444444444444422222222222222220000000000000000000000000000000000000000000000000222222222000000000000000022222222222222222
44444444444444444444422222222222222222000000000000000000000000000000000000000000000000002200002200000000000000002222222222222222
44442222222244444444422222222222222222200002000000000000000000000000000000000000000000000000000000000000000000022222222222222222
22222222222224444444422222222222222222220222200000000000000000000000000000000000000000000000000000000000000000022222222222222222
22222222222224444444222222222222222222222222220000000000000000000000000000000000000000000000000000000000000000022202222222222222
22222222222222444422222222222222222222222222200000000000000000000000000000000000000000000000000000000000000000022222222222222222
22222222222222222222222222222222222222222222200000000000000000000000000000000000000000000000000000000000000000022222222222222224
22222222222222222222222222222222222222222222200000000000000000000000000000000000000000000000000000000000000000022222222222224444
22222222222222222222222222222222222222222222200000000000000000000000000000000000000000000000000000000000000000222222222222224442
22222222222222222222222222222222222222222222000000000000000000000000000000000000000000000000000000000000000002222222222222222222
22222222222222222222222222222222222222222200000000000000000000000000000000000000000000000000000000000000000022222222222222222222
22222222222222222222222222222222222222220000000000000000000000000000000000000000000000000000000000000000000222222222222222222222
22222222222222222222222222222222222222000000000000000000000000000000000220000000000000000000000000000000002222222222222222222222
22222222222222222222222222222222222220000000000000000000000000000000022220000000000000000000000000000000000022222222222222222222
22222222222222222222222222222222222200000000000000000000000220000000022000000000000000000000000000000000000002222222222222222222
22222222222222222222222222222222000000000000000000000000000222200000000000000000000000000000000000000000000002222222222222222222
22222222222222222222222222222220000000000000000000000000000002200000000000000000000000000000000000000000000002222222222222222222
22222222222222220222220000222222000000000000000000000000000000000000000000000000000000000000000000000000000002222222222222222222
22222222222222222222000000002200000000000000000000000000000000000000000000000000000000000000000000000000000022222222222222222222
22222222222222222222000000000000000000000000000000000000000000000000000000000000000000000000000000000000000222222222222222222222
22222222222000222220000000020000000000000000000000000000000000000002200000000000000000000000000000000000000222222222222222222222
22222222220000002220000000222000000000000000000000000000000000000002200000000000000000000000000000000000000222222222222222222222
00000000000000000000000002222200000000000000000000000000000000000002200000000000000000000000000000000000002222222222222222222222
00000000000000000000000002222200000000000000000000000000000000000002200000000000000000000000000000000000002222222222222222222222
00000000000000000000000002222220000000000000000000000000000000000000000000000000000000000000000011111100022222222222222222222222
00000000000000000000000022222222000000000000000000000000000000000000000000000000000000000000000011111100000000222222222222000000
00000000000000000000000002222220000000000000000000000000000000000000000000000000000000000000000011110000000000002220000000000000
00000000000000000000000022222222000000000000000000000000000000000000000000000000000000000000000000000000000000000000000000000000
00000000000000000000000000222220000000000000000000000000000000000000000000000000000000000000000000000000000000000000000000000000
00000000000000000000000000022222000000000000000000000000000000000000000000000000000000000000000000000000000000000000000000000000
00000000000000000000000000022222000000000000000000000000000000000000000000000000000000000000000000000000000000000000000000000000
00000000000000000000000000002222200000000000000000000000000000000000000000000000000000000000000000000000000000000000000000000000
00000000000000000000000000000222000000000000000000000000000000000000000000000000000000000000000000000000000000000000000000000000
00000000000000000000000000000222000000000000000000000000000000000000000000000000000000000000000000000000000000000000000000000000
00000000000000000000000000000222000000000000000000000000000000000000000000000000000000000000001110000000000000000000000000000000
00000000000000000000000000002222200000000000000000000000000000000000000000000000000000000000001100000000000000000000000000000000
00000000000000000000000000000222220000000000000000000000000000000000000000000000000000000000001110000000000000000000000000000000
00000000000000000000000000000222200000000000000000000000000000000000000000000000000000000000001110000000000000000000000000000000
00000000000000000000000000002222000000000000000000000000000000000000000000000000000000000000001110000000000000000002200200000000
00000000000000000000000000022220000000000000000000000000000000000000000000000000000000000000000000000000000000000222222222200220
00000000000000000000000000222220000000000000000000000000000000000000000000000000000000000000000000000000000000022222222222222222
00000000000000000000000000022200000000000000000000000000000000000000000000000000000000000000000000000000022002222222222222222222
00000000000000000000000000222200000000000000000000000000000000000000200220000000000000000000000000000002222222222200000000222202
00000000000000000000000002222000000000000000000000000000000000000002222222200000000000020000000000000002222222200000000000000000
00000000000000000000000022222200000000000000000000000000000000000022222222220000000000222002200000000022222222000000000000000000
00000000000000000000000222222000000000000000000000000000000000000002222202222000000022222222220000000222200000000000000000000000
00000000000000000000000222222200000000000000000000000000000000000000222222222000000022222222222201102222220000000000000000000000
00000000000000000000002220000000000000000000000000000000000000000000222222222220020002222222222221122220000000000000000000000000
00000000000000000000022200000000000000000000000000000000000000000002222220222222222222222222222222222200000000000000000000000000
00000000000000000000222200000000000000000000000000000000000000000002222220022222222222222222222222222200000000000000000000000000
20000000000000000000222000000000000000000000000000000000000000000022222220222222222222222222222222222220000000000000000000000000
22200220020000000002222200000000000000000000000000000000000000000000222222222222222222222222222222222220000000000000000000000000
22222222222222200022222220000000000000000000000000000000000000000000002222222222222222222222222222222220000000000000000000000000
00222222222222220022222222200222200000002000000000000000000000000000000022222222222222222222222222222222000000000000000000000000
00000000000022222222222222222222220220022200000000000000000000000000002220222222222222222222222222222200000000000000000000000000
00000000000000222222200222222222222222222222000000000000000000000000222222222222222222222222222222222200000000000000000000000000
00000000000000000000000022022222222222222222000000000000000000000022222222222222222222222222222222222220000000000000000000000000
00000000000000000000000000022222222222222220000000000000000000002222222222222222222222222222222222222220000000000000000000000000
00000000000000000000000000222222222222222222000000000000000000222222222222222222222222222222222222222220000000000000000000000000
00000000000000000000000002222222222222222222200000000000000022222222222222222222222222222222222222222220000000000000000000000000
00000000000000000000000022222222222222222222200000000000000022222222222222222222222222222222222222222220000000000000000000000000
00000000000000000000000222222222222222222222222220000002200002222222222222222222222222222222222222222222000000000000000000000000
00000000000000000000002222222222222222222222222220002002220002222222222222222222222222222222222222222332200000000000000000000000
00000000000000000000002222222222222222222222222222222002222022233222222222222222222222444422222222222332200000000000000000000000
00000000000000000000022222222222222222222222222222222022222222233222222222222222222444444444422222222222220000000000000000000000
00000000000000000000222222222222222222222222222222222222222222222222222222222222222444444444422222222222220000000000000000000000
00000000000000000000022222222222222222222222222220022222222222222222222222222222222444444444222222222222222000200000000000000000
00000000000000000000222222222222222222222222222222222222222222222222222222222222222444444442222222222222222002220000000000000000
00000000000000000000022222222222222222222222222222222222222222222222222222222222222442444442222222222222222222222200000000000000
00000000000000000000002222222222222222222222222222200222222222222222222222222222244444444442222222222222222222222200000000000000
00000000000000000000002222222222222222222222222222200222222222222222222222222223244244444442222222222222222222222000000000000000
00000000000000000000000222222222222222222222222202222222222222222222222224222222242244444422222222222222222222222200000000000000
00000000000000000000000000002222222222222222222222200222222222222222222224444444444444444222222222222222222222222220000000000000
00000000000000000000000000000022222222222222222222222222222222222222222222444444444444444242222222222222222222222220000000000000
11100000000000000000000000000022222222222222222222222222222222222222222222244444444444444442222222222222222222222200000000000000
11000000000000000000000000000002222222222222222222222222222222222222222224424444444444444442222222222222222222222000000000000000
11100000000000000000000000000000222222222222222222222222222222222222222224424444444444444442022222222222222222222000000000000000
11100000000000000000000000000000002222222222222222222222222222222222222224424444444444444442222222222222222222220200000000000000
11100000000000000000000000000000002222222222202222222222222222222222222224424444444444444442222222222222222222222220022000000000
00000000000000000000000000000000022222222222022222222222222222222222222224424444444444444442222222222222222222222220020000000000
