11111111111111111111111111111111111111111111111111111100000000000000000000000000000000110021110000002222002111111111111111111111
11111111111111111111111111111111111111111111111111110000000000000000222200000000000000000011110000220220022011111111111111111111
11111111111111111111111111111111111111111111111111110000000000000000222200000000000000000011111100000000002201111111111111111111
11111111111111111111111111111111111111111111111111110000000000022000000000000000000000000000111100000000002201111111111111111111
11111111111111111111111111111111111111111111111111110000000000220000000000000000000000002100111100000000000000111111111111111112
11111111111111111111111111111111111111111111111111110000000000022000000000000000000000222111111100000000000000011111111111111110
11111111111111111111111111111111111111111111111111000000000000220000000000000000000001112211110000000000002222011111111111111111
11111111111111111111111111110000111111111111111111120000000000022000000000000000000000111222000000000000002222011111111111111111
11111111111111111111110000000000001111111111111111110000000000220000000000000000000000111222000000000000000000011111111111111111
11111111111111111111000002222000000011111111111111110000000000000000000000000000000000111122000000000000000000111111111111111111
11111111111111111100000002222002222000111111111111111200000000022000000000000000000000111100000000000000000000111111111111111111
11111111111111111100000000000000002200111111111111111100000000022000000000000000000000111100000000000000000001111111111111111111
11111111111111111100000000000000000000111111111111111100000000002200000000000000000000111111100000000000000001111111111111111111
11111111111111111100000000000000000220111111111111111100000000000000000000000000000000001111111000000022111121111111111111111111
11111111111111111100000000000000002200111111111111111100000000000000000000000000000000000011111000000011111111111111111111111111
11111111111111110000000000000000000220001111111111111112000000000000000000000000000000002111000000000011111111111111111111111111
11111111111111110000000000000000002200001111111111111111000000000000000000000000000000001111000000000011111111111111111111111111
11111111111111110000000000000000000000001111111111111111000000000000000000000000000000001111000000000011111111111111111111111111
11111111111111110000000000000000000000001111111111111111120000000000000000000000000000211100000000000011111111111111111111111111
11111111111111111100000000000000000000001111111111111111110000000000000000000000000000111100000000000011111111111111111111111111
11111111111111111111000000000000000022211111221111111111110000000000000000000000001112111120202020000011111111111111111111111111
00001111111111111111000000000000000022211111222211111111111221110000000011120000111111111100000000000000211111111111111111111111
00000011111111111111000000000000000011221122222222111111111111111111122111110011111111111120202020200000001111111111111111111111
00000000111111111111110000000000001111122222222222111111111111111111111111111111111111110000000000000000001111111111111111111111
00000000001111111111110000001111111111112222222222211111111111111111111111111111111111202020202020200000001111111111111111111111
11110000000011001111110000111111111111112222222222211111111111111111111111111111111100000000000000000000000021111111111111111111
11111100000000001111111111111111112222222222222222111111111111111111111111111111111112222020202000200000000000211111111111111111
11111100000000001111111111111122222222222222222222221111111111111111111111002222111112220000000000000000000000002112111111111111
12211100000000000011111111111122222222222222222222221111111111111111111111200220001122112020202020200000000000000022111111111111
02200000000000000011111111111122222222222222222222221111111111111111111122000000002221111100000000000000000000000021211111111111
22000000000000000011111111111122222222222222222222222211111111111111111122000000002211111111202020200000000000000000001111111111
22000000000000000110111111112222222222222222222222222211111111111111111100000000002211111111000000000000000000000000001111111111
02200000000000000110111111122222222222222222222222222211111111111111112222000000000000001111202020200000202002000000022112211221
00000000000000000000111111122222222222222222222222222211111111111111112222000000000000001111111111000000000000000000022000222200
02200000000000000000001111222222222222222222222222221111111111111111110000000000000000000011111111112020202020200000021000000220
02200000000000000000020222222222222222222222222222221111111111111111120000000000000000000011111111110000000000000000000000000000
00220000000000000000000222222222222222222222222222222111111111111202222000000000000000000011111111020202020202020000000000000220
11111111000000000000020022222222222222222222222222222221111100111202222200000000000000000022111111000000000000000000000000000022
11111111000000000000000202222222222211122222222222222222222001111102222222220222222200002222211111111222020202020000000000000022
11111111000000000000020022222222222111222222222222222222222000111100222220022222222222022112111111111222220000000000000000000220
11111111100000000000000202220222222112222222222222222222222000000002222222022222222222222111111112112222222202020000000000000000
11111111110000000000020000000000001111222222222222222222222000000002222222002220222222221111111111222222222222000000000000000000
11111111110000000000000202020202021111122222222222222222200000000000220220000000000222111111111111222222222222220000000000000000
11111111111100000000020000000000001111122222222222222220000000000000200000000000000021111111111100222222222222221100000000000000
11111111111111000000000202020202021111221222222222222000000000000000000000000000000011111111111100002222222222111100000000000000
11111111111111110000020000000000001111111122222222222000000000000000000000000000000011111111111100000022222221111100000000000000
11111111111111111100000202020202111111111111122222222000000000000000000000000000000011111111111100000022222211111100000000000000
11111111111111111111000000000000111111111111112222200000000000000000000000000000000011111111111100002222222211111100000000000011
11111111111111111111100000000202111111111111122220000000000000000000000000000022220000111111111100222222222222211111111111111111
11111111111111111111110000000000111111111111120000000000000000000000000000002222222200001111111122222222222222221111111111111111
11111221122111111111100000000202111111111111120000000000000000000000000000222222222200001111111022222222222222211111111111111111
21120022220011111111100000000000111111111111110000000000000000000000000000222222000000001111111222222222222222211111111111111111
00220022220011111111110000000202111111111111110000000000000000000000002222222222000000001111111222222222022222111111110000000000
02200000000011111111000000000000111111111111110000000000000000000000002222222200000000221111112222222222220222211111000000000001
00000000000002211100000000020202021111111111110000000000000000000000000022220000000000222222222222222222222222111100000000000111
02200000000002222200000000000000001111111111110000000000000000000000000000000000000000222222222222222222222222211100000000001111
22000000000000000000000002020202021111111111110000000000000000000000000000222200000000222222222222222222222222111100000000001111
02200000000000000000000000000000000111111111000000000000000000000000000000222200000000222222222222222222222221100000000000001120
00000000000000000000000202020202221111111100000000000000000000000000000000000000000000222222222222222222222111000000000000000000
22000000000000000000000000000000222111110000222200000000000000000000000000000000000000002222222222222222221111120000000000000000
02200000000000000000000202020202112211000000222200000000000000000000000110000000000000002222222222222222221111120000000000000000
00000000000000000000000000000011111222000000222222222222000000000000111110000000000000002222222222222222222211220000000000000000
00000000000000001100000202021111111122000000222222222222000110000000111110000000000000002222222222222222222222220000000000000000
00000000000000111100001111001111111122000000002222000000000111110000211200000000000000002222222222222222222222110000000000002222
00000000000011111111111111111111000000000000000000000000000111110000000000000000000000002222222222222222222221110000000000002222
11000022211111111111111111111111000000000002220000000000000021110000000000000000000000222222222222222222222221110000000000000000
11000022211111111111111111111100000000000000220202200000000000000000000000000000000000222222222222222222222111000000000000000000
11111111221111111111111111110002200000000002222222200000000000000000000000000000000000222222222222222222222111000000000000002200
11111111122200111111001111111222000000000000222222000000000000000011110000000000000000222222222222222222221111000000000000002200
11111111112200001111000021111102200000000002222222000000000000000011110000000000000000222111111222222222221111000000220220022000
00000011112200000000000011111122000000000002222222000000000000000011110000000000000000221111111122222222221111000000002222000000
00000000100000000000000011111112200000000002222200000000000000000011110000000000000000001111111111111111211111000011110000111111
00000000000000000000000011111111220000222202222000000000000000000011120000000000000000001111111111111111111111111111111111111111
00000000000000000000000011111111111111222200022200000000000000000000000000000000000000001111111111111111111111111111111111111111
00000000000000000000000011111111111111110000222200000000000000000000000000000002202222001111111111111111111111111111111111111111
00000000000000000000000011111111111111110022222000000000000000000000000000000002222022111111111111111111111111111111111111111111
00000000000000000000000000111111111111111111222200000000000000000000000000000000002222111111111111111111111111111111111111111111
00000000000000000000000000111111111111111111110200000000000000000000000000000000222211111111111111111111111111111111111111111111
00000002222000000000000000111111111111111111112200000000000000000000002222000000222211111111111111111111111111111111111111111111
00022002222000000000000000001111111111111111110000000000000000000000222222000002222200001111111111111111111111111111111111111111
00220000000000000000000000001111111111111111110000000000000000000000222222000222220002222000001111111111111111111111111111111111
00000000000000000000000000001111111111111111110000000000000000000000002222000222220002222002201111111111111111111111111111111111
00220000000000000000000000001111111111111111111122220000000000000000002222000002200000000000221111111111111111111111111111111111
02200000000000000000000000001111111111111111111122222200000000000000222222000002222000000000221111111111111111111111111111111111
00220000000000000000000000001111111111111111111222222222000000000022222222000002220000000000001111111111111111111111111111111111
00220000000000000000000000001111111111111111122222222222000000000022222222220002220000000000001111111111111111111111111111111111
02200000000000000000000000211111111111111122222222222222000000000000000022220002220000000000221111111111111111111111111111111111
00220000000000000000000000111111111111112222222222222222220000000000000000000002220000000000022011111111111111111111111111111111
00220000000000000000000000111111111111222222222222222222222200000000000000002222220000000000220011111111111111111111111111111111
00000000000000000000000000111111111111222222222222222222222200000000000000022222200000000000000011111111111111111111111111111111
00000000000000000000000000111111111111112222222222222222222200000021111111022200000000000000000011111111111111111100000000111111
00000000000000000000000011111111111111112220222222222222222222000011111111112200000000210000001111111111111111110000000000000000
00000000000000000000002111111111111111222222222222222222222222220011111111111220000022211111111111111111111111000000000000000000
00000000000000000000001111111111111111222222222222222222222222111111111111111122000111221111111111111111110000000000000000000000
00000000000000000000001111111111111112222222222222222222222211111111111111111102200011122202021111111111110000000000000000000000
00000000000000000000211111111111111122222222222222222222222211111111111111111111111011122200001111111111000000000000022220000000
00000000000000000000111111111111111122222222222222220222222222111111111111111111111111020202021111111100000000000000022220022000
00000000000000000000111111111111111122222222222222222222222222222211111111111111111111000000000011111112000000000000000000002200
11000000000000000021111111111111112222220022222222222222222222222211111111111111111111020202020211111111000000000000000000002200
11111111111111120011111111111111022222222222222222222202222222222222111111111111111100000000000011111111000000000000000000000000
11111111111111110011111111111111122222222222222222222222222222222222221111111111110202020202020202111111000000000000000000000220
11111111111111111111111111111111112222201222222222222222222222222222222111111111000000000000000000111111000000000000000000002200
11111111111111111111111111111111111111111222222222222222222222222222222111111102020202020202020202111100000000000000000000002200
11111111111111111111111111111100111111112211102222222222222222222222222211110000000000000000000000001112000000000000000000000220
11111111111111111111111111111100000000222111222222222222222222222222222222020202020202020202020202021111000000000000000000002200
11111111111111111111111111111100000000222111222222222222222220222222222222000000000000000000000000001111000000000000000000002200
11111111111111111111111111111100000000222211122222222222222222222222222222020202020202000002020202021111000000000000000000000000
11111111111111111111111111110000000000000011122221112222222111222222222200000000000000000000000000001111000000000000000000000000
11111111111111111111111111000000000000000011111111111221122211122222220202020202000000000000000000001111000000000000000000000000
11111111111111111111111111000000000000000000111111111221111111122200000000000000000000000000000000001111000000000000000000000000
11111111111111111111111111000000000000000000001111111111111111100202020202000000000000111100000000000111120000000000000000000000
11111111111111111111111100022000000000000000000011111111111111111000000000000000000011111111000000000111110000000000000000000000
11111111111111111111111100220000000000000000000011111111111111011000020200000000001111111111110000000011110000000000000000000000
11111111111111111111111100022000000000000000001111111111110000000000000000000000001111111111110000000000111200110000000000000000
11111111111111111111111100220000000000000000001111111111111100000000000000000000001111111111110000000000111100120000000000000000
11111111111111111111111100000000000000000000000011111111111100000000000000000000001111111111000000000000111111122200000000000000
11111111111111111111111100022000000000000000000011111111110000000000000000000000001111111111000000000000001111221100000000000000
11111111111111111111111111002222022220000000001111111111000000000000000000000022111111111111000000000000000022211100000000000000
11111111111111111111111111110000022220000000111111111111000000000000000000000011111111111111000000000000000022211100000000000000
11111111111111111111111111111100000000000000111111111111000000000000000001111111111111111111000000000000000000001112000000000000
11111111111111111111111111111111000000000000111111111111000000000000000001111111111111111102222000000000000000001111000000000000
11111111111111111111111111111111110000000011111111111111000000000000000001111111111111111112222000000000000000211111000000000000
11111111111111111111111111111111110000001111111111111100000000000000000000111111111111111111000000000000000000211100000000000000
11111111111111111111111111111111110000111111111111111100000000000000000011111111111111111111000000000000000000111100000000000000
11111111111111111111111111111111111111111111111111111100000000000000002211111111111111111111022000000000000011111100000000000000
11111111111111111111111111111111111111111111111111110000000022220220022011111111111111111111002202200222200011111112211200111100
11111111111111111111111111111111111111111111111111110000000000002222000011111111111111111111000000222200000000111111111111111111
11111111111111111111111111111111111111111111111111111111111111111111111111111111111111111111111111111111111111111111111111111111
