44444444444444444444444442222222200222244444422222222224444444222002222444444444444444444444444442244224444444444444444444444444
44444444444444444444444444422220000222444442222222222222444222200022244444444444444444444444444444444444444444444444444444444444
44444444444444444444444444442220000222244222222222222222444422200222444444444444444444444444444444444444444444444444444444444444
44444444444444444444444444422220000222444422222222222222244222200222244444444444444444444444444444422444444444444444444444444444
44444444444444444444444444442220000222244222222222222222444442222222444444444444444444444444444444444444444444444444444444444444
44444444444444444444444444422220000222444422222222222222244444222222444444444444444444444444444444422444444444444444444444444444
44444444444444444444444444442220000222444222222222222222222442222002222444444444444444444444444444444444444444444444444444444444
44444444444444444444444444442220000002222222222222222222224444222002224444444444444444444444444444422444444444444444444444444444
44444444444444444444444444442222200000222222222222222222222442222002222444444444444444444444444444444444444444444444444444444444
44444444444444444444444444222222222002222222222222222222224444222002224444444444444444444444444444422444444444444444444444444444
44444444444444444444244422222222222222222222222222222222222442222002222444444444444444444444444444444444444444444444444444444444
44444444444444444444222222222222222222222222222222222222224444222002224444444444444444444442444224422444444444444444444444444444
44444444444444444444442222222222222222222222222222222222222444222002222444444444444444444444444444444444444444444444444444444444
44444444444444444444444222222222222222222222222222222222224444422222224444444444444444422442244224422444444444444444444444444444
44444444444444444444444442222222222222222222222222222222222444444224422444444444444442224444444444444444444444444444444444444444
44444444444444444444444444422222222222222222222222222222222224444444444444444444444422222444444444444444444444444444444444444444
44444444444444444444444444442222222222222222222222222222222222244444442444444444444422224444444444444444444444444444444444444444
44444444444444444444444444422222222222222222222222222222222222222444444224444444442222222442244444444444444444444444444444444444
44444224444444444244444444442222222222222222222222222222222222222224444444442444222222224444444442244444444444444444444444444444
44444444444444422444444444422222222222222222222222222222222222222222244444442222222222222442244444444444444444444444444444444444
44444224424444244444422444442222222222222222222222222222222222222222222444444222222222224444444442244444444444444444444444444444
44444444444444444444444224422222222222222222222222222222222222222222222224444422222222222442244444444444444444444444444444444444
44444224442444444244444444442222222222222222222222222222222222222222222242244224222222224444422442244444444444444444444444444444
44444444444444422444444444422222222222222222222222222222222222222222222244422444222222222444444444444444444444444444444444444444
44444424444442244444444444442222222222222222222222222222222222222222224424444444442222224444422442244444444444444444444444444444
44444442444444444444222244422222222222222222222222222222222222222222442444444244444442222444444444444444444444444444444444444444
44444444444444444422000222222222222222222222222222222222222222222244244444444442444422244244422442244444444444444444444444444444
44444444444224422220000000222222222222222222222222222222222222224424444444444444444422444444444444444444444444444444444444444444
44444444444422222222200002222222222222222222222222222222222222442444444444444444444442244444422442244444444444444444444444444444
44444444444222222222222222222222222222222222222222222222222244244444444444444444444444444442244444444444444444444444444444444444
44444444444422222222222222222222222222222222222222222222224424444444444444444444444442244444444442244444444444444444444444444444
44444444444422222222222222222222222222222222222222222224442444444444444444444444444444444442244444444444444444422442244444444444
44444444444422222222222222222222000222222222222222222222444444444444444444444444444442244444444442244444444444222222222444444444
44444424442222222222222222222220000222222222222222222222444444444444444444444444444444444444244444444444444444222222222224444444
44444222222222222222222222222222222222222222222220222224444444444444444444444444444444244444422442244444244422222222222222444444
44444422222222222222222222222222222222222222222000022244444444444444444444444444444444422444444444444442222222222222222222444444
44444222222222222222222222222222222222222222200000022224444444444444444444444444444444444444444442244444222222222222222222244444
44444422222222222222222222222222222222222200000000022244444444444444444444444444444444444442244444444442222222222222222222444444
44444222222222222222222222222222222222222000000000022224444444444444444444444444444444444444444444244444222222222222222222244444
44444422222222222222222222222222222222222000000000022244444444444444444444444444444444444442244444444442222222222222222222444444
44444222222222222222222222222222222222222000000000022224444444444444444444444444444444444444444444444444222222222222222222244444
44444422222222222222222222222222222222222000000000022244444444444444444444444444444444444442244224424442222222222222222222444444
44444222222222222222222222222222222222222000000000022224444444444444444444444444444444444444444444444444222222222222222222244444
44444422222222222222222222222222222222222000000000022244444444444444444444444444444444444442244224444444222222222222222222444444
44444422222222222222222222222222222222222000000000022224444444444444444444444444444444444444444422444444422222222222222222244444
44444444222222222222222222222222222222222000000000022244444444444444444444444444444444444442244422224444444222222222222222444444
44444444422222222222222222222222222222222000000000022224444444444444444444444444444444444444222220022244444442222222222222244444
44444444444222222222222222222222222222222200000000022222444444444444444444444444444444444442222200002222444444422222222224444444
44444424444422222222222222222222222222222220000220022222444444444444444444444444444444444444422220000000224444442222222244444444
44444444444222222222222222222222222222222222222222222222224444444444444444444444444444444444444222000000022244422222222224444444
44444224444422222222222222222222222222222222222222222222222244444444444444444444444444444444444422200000022244442222222244444444
44444444444222222222222222222222222222222222222222222222222222444444444444444444444444444444444422200000022224422222222224444444
44444444422222222222222222222222200022222222224444222222222222224444444444444444444444444444444422220000022244442222222222244444
44444442222222222222222222222222200002222222442444442222222222222244444444444444444444444444442222222200022224422222222222444444
44444222222222222222222222222222222222222244244444444422222222222222444444444444444444444444222222222220022244442222222222244444
44444422222222222222222222222222222222224424444442444444222222222222224444444444444444444422222222222222222224422222222222444444
44444222222222222222222222222222222222442444444444424444442222222222222244444444444444442222222222222222222222222222222222244444
44444422222222222442222200222222222244244444444444444244444422222222222222444444444444222222222222222222222222222222222222444444
44444222222222224444222000022222224424444444444444444442444444222222222222224444444422222222200022222222222222222222222222244444
44444422222222222442222000022224442444444444444444444444424444442222222222222244442222222222200002222222222222222222222224444444
44444222222222224444222000022222444444444444444444444444444244444422222222222222222222222222222222222222222222222222222444444444
44444442222222222442222000000222244444444444444444444444444442444444222222222222222222222222222222222222222222222222244444444444
44444444222222224444222000000222444444444444444444444444444444424444442222222222222222222222222222222222222222222222444444244444
44444442222222222442222000000222444444444444444444444444444444444244444442222222222000222222222222222222222222222222244444444444
44444444222222224444442220000002224444444444444444444444444444444442444422222000200000022222222222222222222222222222444442244444
44444442222222222444444222200000022224444444444444444444444444444444444422222000000000022222222222222222222222222222244444444444
44444422222222222224444442222002222244444444444444444444444444444444444442222000000000022222222222222222222222222222222444444444
44444422222222222222244444422222244224444444444444444444444444444444444444222000000000022222222222222222222222222222222224444444
44444222222222222222222444444222444444444444444444444444444444444444444442222000000000022222222222222222222222222222222222244444
44444422222222222222222224444442244224444444444444444444444444444444444444222000000000022222222222222222222222222222222222444444
44444222222222222222222244444444444444444444444444444444444444444444444442222000000000022222222222222222222222222222222222244444
44444422222222222222222224444442444224444444444444444444444444444444444444222000000000022222222222222222222222222222222222444444
44444222222222222222222244444444444444444444444444444444444444444444444442222000000000022222222222222222222222222222222222244444
44444422222222222222222224444444444224444444444444444444444444444444444444222000000000022222222222222222222222222222222222444444
44444222222222222222222244444224444444444444444444444444444444444444444442222000000000022222222222222222222222222222222222244444
44444422222222222222222224444444444444444444444444444444444444444444444444222000000000022222222222222222222222222222222222444444
44444222222222222222422244444224444444444444444444444444444444444444444442222000000222222222222222222222222222222222222222244444
44444422222222222222444224444444444444442444444444444444444444444444444444222000022222222222222222222222222222222222224222444444
44444422222222222444244444444224442444444224444444444444444444444444444442222002222222222222222222222222222222222222224442244444
44444442222222222244444444444444444224444444444444444444444444444444444422222222222222222222220000222222222222222224442444444444
44444444422222222244444444444224444444444224444444444444444444444444444422222222222222222222200002222222222222222222444444444444
44444444444244422444444444444444444224444444444444444444444444444444442222222222222222222222222222222222222222222222244444444444
44444444444444444444444444444224444444444224444444444444444444444444222222222222222222222222222222222222222222222222444444444444
44444444444444444444444444444444444244444444444444444444444444444422222222222222222222222222222222222222222222222222244444444444
44444444444444444444444444444224422444444224444444444444444444442222222222222222222222222222222222222222000022222222444444444444
44444444444444444444444444444444444444444422444444444444444444222222222222222222222222222222222222222220000002222442244444444444
44444444444444444444444444444224422444244222444444444444444422222222222222222222222222222222222222222222200222244444444444444444
44444444444444444444444444444444444444422222224444444444442222222222222222222222222222222222222222222442222224444444444424444444
44444444444444444444444444444224422444442222222244422444222222222222222222222222222222222222222222224444444444444244444442244444
44444444444444444444444444444444444444422222222222222222222222222222222222222222222222222222222222222444444444424444444444444444
44444444444444444444444444444224422444442222222222244222222222222222222222222222222222222222222222224444444444444444422442244444
44444444444444444444444444444444444224422222222222444444222222222222222222222222222222222222222222222444244444444444444444444444
44444444444444444444444444444224444444442222222242244444422222222222222222222222222222222222222222224444424444444244422442244444
44444444444444444444444444444444444224422222222244424444444222222222222222222222222222222222222222222444444444422444444444444444
44444444444444444444444444444244444444442222224424444444444442222222222222222222222222222222222222224444444444244444444444244444
44444444444444444444444444444444444244422224442444444444244444422222222222222222222222222222222222222442444444444444444444444444
44444444444444444444444444444444444444442222444444444444422444444422222222222222222222222222222222224444444444444444444444444444
44444444444444444444444444442442244444422222444444444444444444444442222222222222222222222222222222222444444444444444444444444444
44444444444444444444444444444444444444442224444444444444422444444444422222222222222222222222222222222224444444444444444444444444
44444444444444444444444444422442244224422444444444444444442222224444442222222222222222222222222222222222244444444444444444444444
44444444444444444444444444444444444444444444444444444444422222022244422222222222222222222222222222222222422444444444444444444444
44444444444444444444444444422442244244444444444444444444442220022244442222222222222222222222222222222222444244444444444444444444
44444444444444444444444444444444444444444444444444444444422220022224422222222222222222222222222222222244244444444444444444444444
44444444444444444444444444422442244444444444444444444444442220022244442222222222222222222220022222244424444444444444444444444444
44444444444444444444444444444444444444444444444444444444422220022224422222222222222222222200002222224444444444444444444444444444
44444444444444444444444444422444444444444444444444444444442220022244442222222222222222222220000002222444444444444444444444444444
44444444444444444444444444444444444444444444444444444444422220022224422222222222222222244222000002224444444444444444444444444444
44444444444444444444444444422444444444444444444444444444444222222244444222222222222222444422200002222444444444444444444444444444
44444444444444444444444444444444444444444444444444444444444422222244444422222222222222244222200002224444444444444444444444444444
44444444444444444444444444442444444444444444444444444444444222220222244222222222222222444422200002222444444444444444444444444444
44444444444444444444444444444444444444444444444444444444444422200222444422222222222222444222200002224444444444444444444444444444
44444444444444444444444444444444444444444444444444444444444422200222444422222222222224444422200002222444444444444444444444444444
