00000000000000000000222111111111111111111111110022220011111111111111111112000002222000000000001111111111110000000000000000000011
00000000222200000022222211111111111111111111002202202222111111111111111100000002222000220000000011111112000000000000000000000011
00002200222200000022222221111111111111111100220000000000111111111111111200000000000000022000000011111112000000000000000000000000
00022000000000000022222221111111111111111100220000000000111111111111111200000000000000000000000021111112000000000000000000000000
00000000000000000022222221111111111111111100000000000000111111111111111100000000000000022000000021111112000000000000000000000000
00220000000000000022222221111111111111111100000000000000111111111111111112000000000000002200000021111112000000000000000000000000
00022000000000000022222221111111111111111122220000000000001111111111111112000000000000002200000021111112000000000000000000000000
00220000000000000022222222111111111111111122220000000000001111111111111112000000000000022000001111111112000000000000000000000000
00220000000000000022222222211111111111111122220000000000001111111111111112000000000000000000111111111112000000000000022220000000
00022000000000000011112222222222111111112222222200000000001111111111111112000000000000000011111111111112000000000000022220022000
00000000000000001111111222222222221111222222222222000000001111111111111112000000000000002111111111111112000000000000000000002200
00000000000000002111111122222222220022222222222222220000001111111111111112000000000000111111111111111112000000000000000000000000
00000000000000000011110022222222002222222222222222222200001111111111111112000000000011111111111111111112000000000000000000002200
00000000000000000011111122222200222222222200002222222222001111111111111112000000001111111111111111111112000000000000000000000220
00000000000000001111111111220022222222220000000022222222221111111111111112000000211111001111111111111112000000000000000000002200
00000000000000002111111111110222222222000000000000222222222211111111111111000022221110221111111111111112000000000000000000002200
00001111000000001111111111110222222222000000000000222222222222111111111111112222222111221111111111111100000000000000000000000220
00011111120000111111111111110222222222000000000000222222222222221111111111111122222222221111111111111200000000000000000000002200
00011111111111111111111111110222222222000022220000222222222222222211111111111112222222221111111111111200000000000000000000002200
00011111111111111111111111110222222222002222222200222222222222222222111111111111222222221111111111111200000000000000000000000000
00011111111111111111111111110222222222222222222222222222222222222222221111111122222222221111111111111200000000000000000000000000
00011111111111111111111111110222222222222222222222222222222222222222220011111122222222221111111111111000000000000000000000000000
00011111111111111111111111110222222222002222222200222222222222222222002211111111222222221111111111111000000000000000000000000000
00011111111111111111111111110222222222000022220000222222222222222200222221111112222222221111111111111000000000000000000000000000
00011111111111111111111111110222222222000000000000222222222222220022222222211222222221221111111111111000000000000000000000000000
00022111111111111111111111110222222222000000000000222222222222002222222222222222222111001111111111111000000000000000000000000000
00000211111111111111111111110222222222000000000000222222222200222222222222000022211110111111111111111000000000000000000000000000
00000002211111111111111111111222222222220000000022222222220022222222222200000000211100111111111111111200000000000000000000000000
00020000011100000011111111112222222222222200002222222222002222222222220000000000002111111111111111111200000000000000000000000000
00020000011100000000111111222222222222222222222222222222222222222222000000000000002111111111111111111200000000111111110000000000
00000002211100000000001122222222111122222222222222222212222222222200000000000000002111111111111111111200000011111111111100000000
00000222221112000000222222222211111111222222222222222211122222220000000000000000002111111111111111111200002111111111111111000000
00021111222111000002222222221111111111122222222211112221111222000000000000000000002111111111111111111200222211120000001111110000
00211111122222000002222222221111111111222222221111111100111222000000000000000000002111111111111111111111112221110000000011111000
22211111112200000002222222222211111122222222111111111111112222000000000000000000002111111111111111111111111222220000000000111000
22211100000000000002222222222222112222222211111111111111122222000000000000000000000021111111111111111111111122000222200000111000
22211100000000000002222222222222202222221111111111111111122222000000000000000000000000211111111111111111000000000222200000111000
22211122000000000002222222222222222222111111111111111111122222000000000000000000000000002111111111111111000000000000000022111000
22211120000000000002222222222222222222111111111111111111122222000000000000000000000000002111111111111111000000000000000002111000
22211122000000000002222222222222222222111111111111111111122222000000000000000000000000002111111111111111000000000000000022111000
22211120000000000002222222222222222222111111111111111111122222000000000000000000000000002111111111111111000000000000000002111000
22211100000000000002222222222222222222111111111111111111122222000000000000000000000000002111111111111111000000000000000022111000
22211120000000000002222222222222222222111111111111111111122222000000000000000000000000002111111111111111000000000000000002111000
22211122000000000002222222222222222222111111111111111111122222000000000000000000000000222111111111111111000000000000000022111000
22211100000000000002222222222222222222111111111111111111122222000000000000000000000022222111111111111111110000000000000000111000
22222111000000000002222222222222222222111111111111111111112222000000000000000000002222222111111111111111111100000000000000111200
22221111110000000002222222222222222222111111111111111111111222000000000000000000002222222111111111111111111111000000000000111222
22211111111100000002222222222222222222211111111111111111112222000000000000000000002222222111111111111111111111110000000011112222
22211111111100000002222222222222222222221111111111111111122222220000000000000000002222222211111111111111111111110000000011122222
22211111111100000002222222222222222222222211111111112222222222222200000000000000002222222222111111111111111111110000000011122222
22211111111100000002222222222222111122222222112222002222222222222222000000000000222222222222211111111111111111110000000011112222
22221111111100000002222222222211111111222222222222220022222222222222220000000022222222222222221111111111111111110000000011111222
22221111110000000000022222222111111111112222222222222200222222222222222222222222222222222222222111111111111111110000000000111222
22211111000000000000000000222211111111112222222222222222002222222222222222222222222222222222222222211111111111110000000000111222
22211100000000000000000022222222111111222222222222222222220022222222222222222222222222222222222022221111111111110000000000111222
22211100000000000000001111222222221122222222222222222222222200222222222222222222222222222222222222222211111111110000000000111222
22211100000000000000111111112222222222222222222222222222222222002222222222222222222222222222111122222222110000000000000000111222
22211100000000001111111111111122222222222222222222222222222222220022222222222222222222222211111111222222000000000000000000111222
22211100000000001111111111111112222222222222222222222222222222222200222202222222222222222111111111112200000000000000000000111222
22211100000000001111111111111111122222222222222222222200222222222222002222022222222222222211111111112222222000000000000011112222
22211100000000001111111111111111111222222222222222000000002222222222220022220222222222222222111111222222222220000000001111112222
22222111000000001111111111111111111222222222222200000000000022222222222200220002221111222222221122222222222220000000111111111222
22222111000000001111111111111111111122222222220000000000000000222222222221001111111111112222222222222222222220000000111111111222
22222111000000001111111111111111111111222222220000000000000000002222222111111111111111111122222222222222222220000000111111111222
22221111000000001111111111111111111111122222220000000000000000000022211111111111111111111122222222222222222220000000111111111222
00211111000000001111111111111111111111122222220000000000000000000022211111111111111111111122222222222222222220000000111111122222
00211100000000000011111111111111111111122222220000000000000000000022222111111111111111111122222222222222222220000000001111112222
00011100000000000000111111111111111111122222000000000000000000000022222111111111111111111122222222222222222220000000000011111222
00011122000000000000001111111111111111122200000000000000000000000022222111111111111111111122222222222222222220000000000000111222
00011122100000000000000011111111111111120000000000000000000000000022222111111111111111111122222222222222222220000000000022111222
00011120000000000000000011111111111111120000000000000000000000000022222111111111111111111122222222222222222220000000000002111222
00011122000000000000000011111111111111120000000000000000000000000022222111111111111111111122222222222222222220000000000000111222
00011120000000000000000011111111111111120000000000000000000000000022222111111111111111111122222222222222222220000000000002111222
00011122000000000000000011111111111111120000000000000000000000000022222111111111111111111122222222222222222220000000000022111222
00011120000000000000000011111111111111110000000000000000000000000022222111111111111111111112222222222222222220000000000002111222
00011100000000000000000011111111111111111100000000000000000000000022222111111111111111111122220222222222222220000000000022111222
00011100000222200022110011111111111111111111000000000000000000000022222111111111111111112222222222222222222220000000000000111222
00011100000222201222211111111111111111111111120000000000000000000022221111111111111111222222221111222222222220000000221100111222
00011100000000001112222111211111111111111111120000000000000000000022211111111111112222222222111111112222222220000012222111111200
00001111000000002111122200211111111111111111120000000000000000000022221110221111222222222211111111111222222220000011122221110000
00000011110000000011120000211111111111111111120000000000000000002222222111220022222222222211111111112222222200000021111222000000
00000000111111111112000000211111111111111111120000000000000000222222222222222222222222222222111111222222220000000000111200000000
00000000002112211100000000211111111111111111120000000000000022222222222222222222222222222222221122222222111100000000111000002000
00000000000000000000000000211111111111111111110000000000002222222222220022222222220000222222222222222211111111000000111000002000
00000000000000000000000000211111111111111111111200000000222222222222002222222222000000002222222222221111111111110011111220000000
00000000000000000000000000011111111111111101112222000022222222222200222222222200000000000022222222221111111111111111111111200000
00000000000000000000000000011111111111111111122222222222222222200022222222222200000000000022222222220011111111111111111111112000
00000000000000000000000000011111111111112222222222111122222222002222222222222200000000000022222222221111111111111111111111111000
00000000000000000000000000011111111111112222222221111112222000222222222222222200002222000022222222221111111111111111111111111000
00000000000000000000000000011111111111112222222211111111220022222222222222222200222222220022222222221111111111111111111111111000
00000000000000000000000000011111111111112222222222111100222222222222222222222222222222222222222222221111111111111111111111111000
00000002222000000000000000211111111111112222222222111111002222222222222222222222222222222222222222221111111111111111111111111000
00022002222000000000000000211111111111112222222211111111110022222222222222222200222222220022222222221111111111111111111111111000
00220000000000000000000000211111111111112222222221111111111100222222222222222200002222000022222222221111111111111111211111111000
00000000000000000000000000211111111111112212222222211111111111002222222222222200000000000022222222221111111111111100002111111000
00220000000000000000000000111111111111112211122222222111111111110022222222222200000000000022222222221111111111110000000011120000
02200000000000000000000021111111111111112221111222000011111111111100222222222200000000000022222222221111111111110000000000000000
00220000000000000000000021111111111111112200111200000021111111111111002222222222000000002222222222221111111111120000000000000000
00220000000000000000000021111111111111112211110000000021111111111111110022222222220000022222222222222211111112000000000000000000
02200000000000000000000021111111111111111112000000000021111111111111110000222222222222222222222222222200111111000000000000000000
00220000000000000000000021111111111111111100000000000021111111111111110000002222222222222222002222220022111111120000000000000000
00220000000000000000000021111111111111120000000000000021111111111111110000000022222222222211110022222222211111120000000000022000
00000000000000000000000021111111111111000000000000000021111111111111110000000000222222221111111122122222222112000000000000002200
00000000000000000000000021111111111200000000000000000021111111111111110000000000002222111111111111111222222222000000000000002200
00000000000000000000000021111111120000022000000000000021111111111111110000000000002222111111111111111112222222000000000000022000
00000000000000000000000021111112000000220000000000000021111111111111110000000000002222001111111111111112222222000000000000002200
00000000000000000000000021111112000000022000000000000021111111111111110000000000000000111111111111111112222222000000000000000000
00000000000000000000000021111112000000220000000000000000111111111111111100000000002200111111111111111112222222000000000000022000
00000000000000000000000021111111000000022000000000000000211111111111111100000000002200111111111111111112222222000000222200220000
00000000000000000000000021111112000000002200000222200000211111111111111102222022022000111111111111111112222222000000222200000000
11111000000000000000000011111111000000000000000222200000111111111111111100000222200000111111111111111111222222000000000000011111
11111111111111111111111111111111111111111111111111111111111111111111111111111111111111111111111111111111111111111111111111111111
