44444444444444444444444444444444444442222222222220222220000000000000000002222022222222222224444444444444444444444444444444444444
44444444444444444444444444444444444222222222222222222000000000000000000000022222222222222222244444444444444444444444444444444444
44444444444444444444444444444444444422222222222222200000000000000000000000000222222222222222444444444444444444444444444444444444
44444444444444444444444444444444444222222222222222200000000000000000000000000222222222222222244444444444444444444444444444444444
44444444444444444444444444444444444422222222222222200000000000000000000000000222222222222222444444444444444444444444444444444444
44444444444444444444444444444444444222222222222222200000000000000000000000000222222222222222244444444444444444444444444444444444
44444444444444444444444444444444422222222222222002200000000000000000000000000220022222222222222444444444444444444444444444444444
44444444444444444444444444444442222222222222222202200000000000000000000000000222022222222222222224444444444444444444444444444444
44444444444444444444444444444222222222222222222222200000000000000000000000000222222222222222222222244444444444444444444444444444
44444444444444444444444444422222222222222222200222200000000000000000000000000222200222222222222222222444444444444444444444444444
44444444444444444444444444442222222222222222220222222000000000000000000000022222222222222222222222224444444444444444444444444444
44444444444444444444444444422222222222222222222222222222000000000000000002222222222222222222222222222444444444444444444444444444
44444444444444444444444444442222222222222222222222222222200000000000000222222222222222222222222222224444444444444444444444444444
44444444444444444444444444422222222222222222222222222222200000000000000222222222222222222222222222222444444444444444444444444444
44444444444444444444444444442222222222222222222222222222200000000000000222222222222222222222222222224444444444444444444444444444
44444444444444444444444444422222222222222222222222222222000000000000000022222222222222222222222222222444444444444444444444444444
44444444444444444444444444442222222222222222222222222200000000000000000000222222222222222222222222224444444444444444444444444444
44444444444444444444444444444442222222222222222222200000000000000000000000000222222222222222222224422444444444444444444444444444
44444444444444444444444444444444222222222222222222222200000000000000000000022222222222222222222244444444444444444444444444444444
44444444444444444444444444444442222222222222222222422220000002200220000022222422222222222222222224444444444444444444444444444444
44444444444444444444444444444444222222222222222222444222200222222222200222244422222222222222222244444444444444444444444444444444
44444444444444444444444444444442222222222222222244244442222224422442222224444444222222222222222224444444444444444444444444444444
44444444444444444444444444444222222222222222224424444444422444444444424444424444442222222222222222244444444444444444444444444444
44444444444444444444444444422222222222222222442444444444444444444444444444444244444422222222222222222444444444444444444444444444
44444444444444444444444444442222222222222244244444444444444442244444444444444442444444222222222222224444444444444444444444444444
44444444444444444444444444422222222222224424444444444444444444444444444444444444424444442222222222222444444444444444444444444444
44444444444444444444444444442222222224442444444444444444444444444444444444444444444244444442222222224444444444444444444444444444
44444444444224422444444444422222222222444444444444444444444224422442444444444444444442444422222222222444444444422442244444444444
44444444442222222224444442222222222222244444444444444444444444444444444444444444444444444222222222222224444442222222224444444444
24444444442222222244444222222222222222444444444444444444444224422442244444444444444444444422222222222222244444222222224444444442
22242444222222222224422222222222222222244444444444444444444444444444444444444444444444444222222222222222222442222222222244424222
22222222222222222222222222222222222222444444444444444444444224422444244444444444444444444422222222222222222222222222222222222222
22222222222222222222222222222222222222244444444444444444444444444444444444444444444444444222222222222222222222222222222222222222
22222222222222222222222222222222222222224444444444444444444444444444444444444444444444442222222222222222222222222222222222222222
22222222222222222222222222222222222222222244444444444444444442444224444444444444444444222222222222222222222222222222222222222222
22222222222222222222222222222222222222200222444444444444444444444444444444444444444422200022222222222222222222222222222222222222
22222222222222222222222222222222222222200022224444444444444442244224444444444444442222000222222222222222222222222222222222222222
22222222222222222222222222222222222222222222224444444444444444444444444444444444442222222222222222222222222222222222222222222222
22222222222222222222222222222222222222222222222244444444444442244224444444444444222222222222222222222222222222222222222222222222
22222222222222222442222222222200002222222222222222444444444444444444444444444422222222222222220022222222222224422222222222222222
22222222222222224444222222222220000222222222222222224444444442244444444444442222222222222222200002222222222244442222222222222222
22222222222222222442222222222222222222222222222222222244424444444444442444222222222222222222222222222222222224422222222222222222
44222222222222224444222222222222222222222222222222222222224444444444422222222222222222222222222222222222222244442222222222222244
44442222222222224442222000222222222222222222222222222222224444422444442222222222222222222222222222222200022224422222222222222444
44444224442442444444222000022222222222222222222222222222222442222224422222222222222222222222222222222000022244444244422442244444
44444444444444444444222002222222222222222222222222222222222222222222222222222222222222222222222222222220022244444444444444444444
22444444444444444422200022244222222222222222222222222222222222222222222222222222222222222222222222244222200222444444444444444422
02224444444444442222200222444422222222222222222222222222222222222222222222222222222222222222222222444422200222224444444444442220
00022222222222220002200222244422222222222222222222222222222222222222222222222222222222222222222222244222200220022222222222222000
00000200022002200000000222444442222222222222222222222222222222222222222222222222222222222222222224444422200000002220022000200000
00000000000000000000000222444444222222222222222222222222222222222222222222222222222222222222222244444422200000000000000000000000
00000000000002200220022224444442222222222222222222222222222222222222222222222222222222222222222224444442222002200220000000000000
00000000000222222222222444444444222222222222222222222222222222222222222222222222222222222222222244444444422222222222200000000000
00000000022222222222224444442442222222222222222222222222222222222222222222222222222222222222222224444444442222222222222000000000
00000002222220022002222444444444222222222222222222222222222222222222222222222222222222222222222244444444422220022002222220000000
00000222222000000000022224444442222222222222222222222222222222222222222222222222222222222222222224444442222000000000022222200000
00022222200000000000000222244222222222222222222222222222222222222222222222222222222222222222222222244222200000000000000222222000
02222220000000000000000002222222222222222222222222222222222222222222222222222222222222222222222222222220000000000000000002222200
02222220000000000000000002222222222222222222222222222222222222222222222222222222222222222222222222222220000000000000000002222220
02222220000000000000000002222222222222222222222222222222222222222222222222222222222222222222222222222220000000000000000002222220
22222000000000000000000002222222222222222222222222222222222222222222222222222222222222222222222222222220000000000000000000022222
22200000000000000000000002222222222222222222222222222222222222222222222222222222222222222222222222222220000000000000000000000222
22200000000000000000000002222222222222222222222222222222222222222222222222222222222222222222222222222220000000000000000000000222
22200000000000000000000000222222222222222222222222222222222222222222222222222222222222222222222222222200000000000000000000000222
22200000000000000000000000000222222222222222222222222222222222222222222222222222222222222222222222200000000000000000000000000222
22200000000000000000000000000222222222222222222222222222222222222222222222222222222222222222222222200000000000000000000000000222
22200000000000000000000000000222222222222222222222222222222222222222222222222222222222222222222222200000000000000000000000000222
22222000000000000000000000000222222222222222222222222222222222222222222222222222222222222222222222200000000000000000000000022222
22222220000000000000000000000222222222222222222222222222222222222222222222222222222222222222222222200000000000000000000002222222
02222220000000000000000000022222222222222222222222222222222222222222222222222222222222222222222222222000000000000000000002222220
02222220000000000000000002222222222222222222222222222222222222222222222222222222222222222222222222222220000000000000000002222220
02222222200000000000000222222222222222222222222222222222222222222222222222222222222222222222222222222222200000000000000222222220
00022222222000000000222222244222222222222222222222222222222222222222222222222222222222222222222222244222222000000000222222222000
00000022222220022202222224444442222222222222222222222222222222222222222222222222222222222222222224444442222220022202222222000000
00000022222222222222222444444444222222222222222222222222222222222222222222222222222222222222222244444444422222222222222220000000
00000000022222222222224444424442222222222222222222222222222222222222222222222222222222222222222224442444442222222222220000000000
00000000000022222222224444444444222222222222222222222222222222222222222222222222222222222222222244444444442222222222200000000000
00000000000022200020002244444442222222222222222222222222222222222222222222222222222222222222222224444444222002200220000000000000
00000000000000000000002222244444222222222222222222222222222222222222222222222222222222222222222244444222220000000000000000000000
00000220022002200000000222444442222222222222222222222222222222222222222222222222222222222222222224444422200000000220022002200000
00022222222222222002000222244222222222222222222222222222222222222222222222222222222222222222222222244222200020022222222222222000
02222444244224422222200222444422222222222222222222222222222222222222222222222222222222222222222222444422200222224442444224442220
22444444444444444422200222444222222222222222222222222222222222222222222222222222222222222222222222244422200222244444444444444222
44444444444444444442220000222222222222222222222222222222222222222222222222222222222222222222222222222220022224444444444444444442
44444224422442244444222000222222222222222222222222222222222442222224422222222222222222222222222222222000022244444224422442244444
44422222222222222442222000022222222222222222222222222242224444422444442224222222222222222222222222222000022224442222222222222444
42222222222222224444222222222222222222222222222222222244424444444444422444222222222222222222222222222222222244442222222222222224
22222222222222222442222222222222222222222222222222224424444444444444444444442222222222222222222222222222222224422222222222222222
22222222222222224444222222222222002222222222222222442444444444244244444244444422222222222222200022222222222244442222222222222222
22222222222222222442222222222220000222222222222244244444444444444444444442444444222222222222200002222222222224422222222222222222
22222222222222222222222222222222222222222222244424444444444442244224444444424444444222222222222222222222222222222222222222222222
22222222222222222222222222222222222222222222224444444444444444444444444444444244442222222222222222222222222222222222222222222222
22222222222222222222222222222222222222220022224444444444444442244224444444444444442222002222222222222222222222222222222222222222
22222222222222222222222222222222222222200222244444444444444444444444444444444444444422200222222222222222222222222222222222222222
22222222222222222222222222222222222222222224444444444444444442244444444444444444444442222222222222222222222222222222222222222222
22222222222222222222222222222222222222222444444444444444444444444444444444444444444444422222222222222222222222222222222222222222
22222222222222222222222222222222222222224444444444444444444444444444444444444444444444442222222222222222222222222222222222222222
22222222242222222222222222222222222222222444444444444444444244442442244444444444444444422222222222222222222222222222224222222222
22244224442222222224422222222222222222224444444444444444444444444444444444444444444444442222222222222222222442222222224442244222
44444444444442222244444222222222222222222444444444444444444224422442244444444444444444422222222222222222444444222224442444444444
44444442444422222224444442222222222222224444444444444444444444444444444444444444444444442222222222222244444442222222444444444444
44444444444424422444444444422222222222224444444444444444444424424442244444444444444444442222222222222444444444422442444444444444
44444444444444444444444444442222222222224444444444444444444444444444444444444444444444442222222222224444444444444444444444444444
44444444444444444444444444422222222222222244444444444444444444444444444444444444444444222222222222222444444444444444444444444444
44444444444444444444444444442222222222222222444444444444444444244444444444444444444422222222222222224444444444444444444444444444
44444444444444444444444444442222222222222222224444444444444444444444444444444444442222222222222222222442444444444444444444444444
44444444444444444444444444444222222222222222222244444444444444444444444444444444222222222222222222444444444444444444444444444444
44444444444444444444444444444442222222222222222222444244200244444444200244244422222222222222222224444444444444444444444444444444
44444444444444444444444444444444222222222222222222222222200002200220000222222222222222222222222244444424444444444444444444444444
44444444444444444444444444444442222222222222222222222222200000000000000222222222222222222222222224444444444444444444444444444444
44444444444444444444444444444444222222222222222222222222200000000000000222222222222222222222222244444444444444444444444444444444
44444444444444444444444444422442222222222222222222222222200000000000000222222222222222222222222224422444444444444444444444444444
44444444444444444444444444442222222222222222222222222222200000000000000222222222222222222222222222224444444444444444444444444444
44444444444444444444444444422222222222222222222222222222000000000000000022222222222222222222222222222444444444444444444444444444
44444444444444444444444444442222222222222222222222222200000000000000000000222222222222222222222222224444444444444444444444444444
44444444444444444444444444422222222222222222222222200000000000000000000000000222222222222222222222222444444444444444444444444444
44444444444444444444444444442222222222222222222222200000000000000000000000000222222222222222222222224444444444444444444444444444
44444444444444444444444444422222222222222222200222200000000000000000000000000222200222222222222222222444444444444444444444444444
44444444444444444444444444442222222222222222222222200000000000000000000000000222220222222222222222224444444444444444444444444444
44444444444444444444444444442222222222222222222222200000000000000000000000000222222222222222222222222444444444444444444444444444
44444444444444444444444444444222222222222222222002200000000000000000000000000220022222222222222222244444444444444444444444444444
44444444444444444444444444444442222222222222222002200000000000000000000000000222222222222222222224444444444444444444444444444444
44444444444444444444444444444444442222222222222222200000000000000000000000000222222222222222222444444444444444444444444444444444
44444444444444444444444444444444444222222222222222200000000000000000000000000222222222222222244444444444444444444444444444444444
44444444444444444444444444444444444422222222222222200000000000000000000000000222222222222222444444444444444444444444444444444444
44444444444444444444444444444444444222222222222222200000000000000000000000000222222222222222244444444444444444444444444444444444
44444444444444444444444444444444444422222222222222222000000000000000000000022222222222222222444444444444444444444444444444444444
44444444444444444444444444444444444222222222222220022220000000000000000022222002222222222222444444444444444444444444444444444444
