00000000000000000000000000000000211111000000001111111111120000222200002111111111110000000011111100000000000000000000000000000000
00000000000000000000000000000000211100000000000011111112002200222200220021111111000000000000111200000000000000000000000000000000
00000000000000000000000000000000211100000000000011111200022000000000022000211112000000000000111200000000000000000000000000000000
00000000000000000000000000000000211100000000000022110000022000000000000000001112000000000000111200000000000000000000000000000000
00000002222000000000000000000000111100000000000011110000000000000000022000001112000000000000111100000000000000000000222200000000
00000002222000000000000000000011111100000000001111110000220000000000002200001111110000000000111111000000000000000000222200000000
00000000000000000000000000001111110000000000111111110000000000000000000000001111111200000000001111110000000000000000000000002200
00000000000000000000000000111111000000000000221111110000000000000000000000001111111200000000000011111100000000000000000000000000
00220000000000000000000021111100000000000000111111110000000000000000000000001111111100000000000000111111000000000000000000000220
02200000000000000000000021110000000000000011111111110000000000000000000000001111111112000000000000001112000000000000000000002200
02200000000000000000000021110000002200000011111112111100000000000000000000111122111111000002202200001112000000000000000000002200
00220000000000000000000021110002222022000000111100001111000000000000000011110000111100000022000220001112000000000000000000000220
02200000000000000000000011110022000000000000000000000011110000000000001111000000000000000000000022001111000000000000000000002200
00220000000000000000000021110000000000000000000000002221110000000000001112220000000000000000000000001112000000000000000000000220
00220000000000000000000011110022000000000000000000222222110000000000001122222200000000000000000022001112000000000000000000002200
00022220000000000000000021110220000000000000000000222222220000000000002222222200000000000000000002201112000000000000000000022000
00000000000000000000000021110000000000000000000011112222220000000000002222221112000000000000000000001112000000000000000000000000
00000000000000000000000021111111000000000000000011111222000000000000000022211111000000000000000011111112000000000000000000000000
00000000000000000000000011111111000000000000000000111100000000000000000000111110000000000000000011111111000000000000000000000000
00000000000000000000001111111111000000000000000022111111000011111111000011111122000000000000000011111111110000000000000000000000
00000000000000000000002111111111000000000000002222211111111111111111111111111222220000000000000011111111120000000000000000000000
00000000000000000000001111111111000000000000222222222111111111111111111111122222222200000000000011111111110000000000000000000000
00000000000000000000211111111100000000000022222222222221111111111111111112222222222222000000000000111111111100000000000000000000
00000000000000000000211111110000000000002222222222222222111111111111111222222222222222220000000000001111111200000000000000000000
00000000000000000000111111110000000000222222222222222222222111111111122222222222222222222200000000001111111100000000000000000000
00000000001111111111111111110000000012222222222222222222221111111111112222222222222222222221000000001111111111111111110000000000
00000022111111111111111111110000000011122222222222222222211111111111111122222222222222222111000000001111111111111111111122000000
11002221111111111111111111110000000021111222222222222222211111111111111222222222222222211112000000001111111111111111111112220011
11112222111200000011111111000000000000111222222222222222111111111111111222222222222222211100000000000011111111000000211122221111
11111122211100000011111100000000000000111122222222222222211111111111111222222222222222111100000000000000111111000000111222111111
00111112222200000011110000000000000000111222222222222222111111111111111122222222222222211100000000000000001111000000222221111100
00001111200000000000000000000000000000111122222222222222211111111111111222222222222222111100000000000000000000000000002211110000
00000000000000000000000000000000000000111111222222222222221111111111122222222222222211111100000000000000000000000000000000000000
00000000000000000000000000000000000000111111112222222222221111111111112222222222221111111100000000000000000000000000000000000000
00000000000000000000000000000000000011111111111122222222222111111111122222222222111111111111000000000000000000000000000000000000
00220000000000000000000000000000002111111111111112222222222111111111122222222221111111111111220000000000000000000000000000000000
00000000000000000000000000000000222211111111111122222222222111111111122222222222111111111111222200000000000000000000000000000220
02200000000000000000000000000011112222111111111222222222221111111111112222222222211111111122221111000000000000000000000000000220
00220000000000000000000000001111111122221122222222222222222111111111122222222222222222112222111111110000000000000000000000002200
00220000000000001111000000211111111111222222222222222222221111111111112222222222222222222211111111112200000011110000000000002200
00022220022220001111000022221111111111222222222222222222111111111111111122222222222222222211111111112222000011110002222022022000
00000022022220001111001111222211111122222222222222222221111111111111111112222222222222222222111111222211110011110002222002200000
11000000000000001111111111112222112222222222222222222211111111111111111111222222222222222222221122221111111111110000000000000011
11110000000000001111111111111122222222222222222222222222221111111111112222222222222222222222222222111111111111110000000000001111
11111111111111111111111111111122222222222222222222222222221111222211112222222222222222222222222222111111111111111111111111111111
11111111111111111111111111111222222222222222222222222222222222222222222222222222222222222222222222221111111111111111111111111111
11111111111111111111111111111122222222222222222222222222222222222222222222222222222222222222222222111111111111111111111111111111
11111111111111111111111111111122222222222222222222222222222222222222222222222222222222222222222222111111111111111111111111111111
11111111111111111111111111111122222222222222222222222222222222222222222222222222222222222222222222111111111111111111111111111111
11111111111111111111111111111111222222222222222222222222222222222222222222222222222222222222222211111111111111111111111111111111
11111111111111111111111111111111222222222222222222222222222222222222222222222222222222222222222211111111111111111111111111111111
11111111111111111111111111111111222222222222222222222222222222222222222222222222222222222222222211111111111111111111111111111111
11111111111111111111111111111111222222222222222222222222222222222222222222222222222222222222222211111111111111111111111111111111
11111111111111111111111111111111222222222222222222222222222222222222222222222222222222222222222211111111111111111111111111111111
11111111111111111111111111111111222222222222222222222222222222222222222222222222222222222222222211111111111111111111111111111111
11111111111112211221111111111111222222222222222222222222222222222222222222222222222222222222222211111111111112211221111111111111
11111111111200000000211111111122222222222222222222222222222222222222222222222222222222222222222222111111111200000000211111111111
11111111120000000000002111112222222222222222222222222222222222222222222222222222222222222222222222221111120000000000002111111111
11111111000000222200000001122222222222222222222222222222222222222222222222222222222222222222222222222211000000222200000011111111
11111111000002200220000011122222222222222222222222222222222200000000222222222222222222222222222222221111000002200220000011111111
11111112000000000000000011122222222222222222222222222222222200000000222222222222222222222222222222222211000000000000000021111111
11111200000000000000000011122222222222222222222222222222220000000000002222222222222222222222222222222111000000000000000000211111
11110000000000000000000011222222222222222222222222222222220000000000002222222222222222222222222222222211000000000000000000001111
11110000000000000000000022221112222222222222222222222222220000000000002222222222222222222222222211112222000000000000022220001111
11110002222000000000000022211112222222222222222222222222220000000000002222222222222222222222222222111222000000000000022220001111
11110002222000000000000000001112222222222222222222222222220000000000002222222222222222222222222211110000000000000000000000001111
11110000000000000000000000001112222222222222222222222222220000000000002222222222222222222222222222110000000000000000000000001111
11111100000000000000000000001112222222222222222222222222222200000000222222222222222222222222222211110000000000000000000000111111
11111111000000000000000000001112222222222222222222222222222200000000222222222222222222222222222222110000000000000000000011111111
11111111000002200220000000111122222222222222222222222222222222222222222222222222222222222222222222111100000002200220000011111111
11111111000000222200000011112222222222222222222222222222222222222222222222222222222222222222222222221111000000222200000011111111
11111111110000000000001111222222222222222222222222222222222222222222222222222222222222222222222222222211110000000000001111111111
11111111111100000000111111111122222222222222222222222222222222222222222222222222222222222222222222111111111100000000111111111111
11111111111111111111111111111111222222222222222222222222222222222222222222222222222222222222222211111111111111111111111111111111
11111111111111111111111111111111222222222222222222222222222222222222222222222222222222222222222211111111111111111111111111111111
11111111111111111111111111111111222222222222222222222222222222222222222222222222222222222222222211111111111111111111111111111111
11111111111111111111111111111111222222222222222222222222222222222222222222222222222222222222222211111111111111111111111111111111
11111111111111111111111111111111222222222222222222222222222222222222222222222222222222222222222211111111111111111111111111111111
11111111111111111111111111111111222222222222222222222222222222222222222222222222222222222222222211111111111111111111111111111111
11111111111111111111111111111111222222222222222222222222222222222222222222222222222222222222222211111111111111111111111111111111
11111111111111111111111111111122222222222222222222222222222222222222222222222222222222222222222222111111111111111111111111111111
11111111111111111111111111111122222222222222222222222222222222222222222222222222222222222222222222111111111111111111111111111111
11111111111111111111111111111122222222222222222222222222222222222222222222222222222222222222222222111111111111111111111111111111
11111111111111111111111111111122222222222222222222222222222222222222222222222222222222222222222222111111111111111111111111111111
11111111111111111111111111111122222222222222222222222222221111222211112222222222222222222222222221111111111111111111111111111111
11110000000000001111111111111122222222222222222222222211221111111111112211222222222222222222222222111111111111110000000000001111
11000000000000001111001111112222111122222222222222222221111111111111111112222222222222222222111122221111110011110000000000000011
00000220022220001111000011222211111111222222222222222222211111111111111222222222222222222211111111222211000011110002222022000000
00022022022220001111000000221111111111222222222222222222222111111111122222222222222222222111111111112200000011110002222002222000
00220000000000001111000000001111111111222222122222222222221111111111112222222222222122222211111111110000000011110000000000002200
00220000000000000000000000000011111122221111111222222222222111111111122222222222211111112222111111000000000000000000000000000220
02200000000000000000000000000000112222111111111112222222221111111111112222222221111111111122221100000000000000000000000000000220
02200000000000000000000000000000002211111111111112222222222111111111122222222221111111111111220000000000000000000000000000002200
00000000000000000000000000000000000011111111111122222222222111111111122222222222111111111111000000000000000000000000000000000000
00000000000000000000000000000000000000111111122222222222222111111111122222222222222111111100000000000000000000000000000000000000
00000000000000000000000000000000000000001111222222222222221111111111112222222222222211110000000000000000000000000000000000000000
00000000000000000000000000000000000000001112222222222222111111111111111122222222222221110000000000000000000000000000000000000000
00000000112200000000000000000000000000001112222222222222211111111111111222222222222221110000000000000000000000000000221100000000
00111111122221000011110000000000000000001112222222222222111111111111111122222222222221110000000000000000001111000012222111111100
11121112222111000011111100000000000000001112222222222222211111111111111222222222222221110000000000000000111111000011122221121111
00000022211112000011111111000000000000001112222222222222111111111111111222222222222221110000000000000011111111000021111222000000
00000000211111111111111111110000000000211122222222222222211111111111111222222222222222111200000000001111111111111111111200000000
00000000001112211121111111110000000000111222222222222222222111111111112222222222222222211100000000001111111112111111110000000000
00000000000000000000111111110000000000222222222222222222221111111111112222222222222222222200000000001111111200000000000000000000
00000000000000000000111111110000000000002222222222222222111111111111111122222222222222220000000000001111111200000000000000000000
00000000000000000000211111110000000000000022222222222211111111111111111111222222222222000000000000001111111200000000000000000000
00000000000000000000001111111100000000000000222222221111111111111111111111112222222200000000000000111111120000000000000000000000
00000000000000000000001111111111000000000000002222211111111111111111111111111222220000000000000011111111110000000000000000000000
00000000000000000000002111111111000000000000000022111122112111111111121112111122000000000000000011111111120000000000000000000000
00000000000000000000000021111111000000000000000000000011110021122112001112000000000000000000000011111111000000000000000000000000
00000000000000000000000011111111000000000000000000000022110000000000001112000000000000000000000011111112000000000000000000000000
00000000000000000000000021111111000000000000000000002221110000000000001112220000000000000000000011111112000000000000000000000000
00000000000000000000000021110220000000000000000000222222110000000000001122222200000000000000000022001111000000000000000000000000
00000002222000000000000021110022000000000000000000222222220000000000002222222200000000000000000002201112000000000000022220000000
00000002222000000000000021110000000000000000000011112222220000000000002222221112000000000000000000001111000000000000022220000000
00000000000000000000000021110022000000000000000011111222000000000000000022211111000000000000000022001112000000000000000000002200
00000000000000000000000011110002200022000000111111110000000000000000000000001112111100000022000220001111000000000000000000000000
00220000000000000000000021110000220220000011111111110000000000000000000000001111111112000002202200001112000000000000000000002200
00000000000000000000000011110000000000000011111111110000000000000000000000001111111111000000000000001112000000000000000000000220
00220000000000000000000021110000000000000000111111110000000000000000000000001111111100000000000000001112000000000000000000002200
00220000000000000000000000111100000000000000111111110000000000000000000000001111111200000000000000111100000000000000000000002200
02200000000000000000000000001111000000000000221111110000220000000000002200001111111200000000000011110000000000000000000000000220
00220000000000000000000000000011110000000000001111110000022000000000000000001111110000000000001111000000000000000000000000002200
00220000000000000000000000000000211100000000000022110000000000000000022000001112000000000000111200000000000000000000000000002200
00022220000000000000000000000000111100000000000011110000022000000000022000001112000000000000111200000000000000000000000000022000
00000022000000000000000000000000211100000000000022110000002200222200220000001112000000000000111200000000000000000000000000000000
11111000000000000000000000000000111100000000000011111100000000222200000000111111000000000000111100000000000000000000000000011111
11111111111111111111111111111111111111111111111111111111111111111111111111111111111111111111111111111111111111111111111111111111
