1111111111111111111111111111111111111111111111111111111111111111111111111111111111111111111111111111111111111111111111111111111111111111111111111
1111111111111111111111111111111111111111111111111111111111111111111111111111111111111111111111111111111111111111111111111111111111111111111111111
1111111111111111111111111111111111111111111111111111111111111111111111111111111111111111111111111111111111111111111111111111111111111111111111111
1111111111111111111111111111111111111111111111111111111111111111111111111111111111111111111111111111111111100000000001111111111111111111111111111
1111111111111111111111111111111111111111111111110000001111111111111111111111111111111111111111111111111111000000000000111111111111111111111111111
1111111111111111111111111111111111111111111111022200000111111111111111111111110000000000001111111111111000000000000000000111111111111111111111111
1111111111111111111111111111111111111111111110022200220000111111111111111111000222000000000111111111110000000000000000000011111111111111111111111
1111111111111111111111111111111111111111111100022202202200011111111111111110000222002200000011111111100000000000000000000011111111111111111111111
1111111111111111111111111111111111111111111000000000000002201111111111111110000222022022000011111111000000000002200000000011111111111111111111111
1111111111111111111111111111111111111111110022200000000000220111111111111110000000000000022011111111000000000022022000000001111111111111111111111
1111111111111111111111111111111111111111110022200000000000000011111111111110222000000000002201111111000000000000000022000000111111111111111111111
1111111111111111111111111111111111111111110022200000000000220011111111111100222000000000000001111110000000000000000002200000111110000001111111111
1111111111111111111111111111111111111111111000000000000000022011111111111100222000000000002201111100000000000000000000000000111100000000111111111
1111111111111111111111111111111111111111111100000000000000220011111111111100000000000000000221111100000000000000000002200001100000000000000111111
1111111111111111111111111111111111111111111100000000000000000011111111111100000000000000002201111100000000000000000000220001000000000000000011111
1111111111111111111111111111111111111111111100000000000000000011111111111110000000000000000001111100000000000000000002200001000000000000000001111
1111111111111111111111111111111111111111111100000000000000000111111111111110000000000000000001111110000000000000000000000001000000000000000000111
1111111111111111111111111111100001111111111000000000000000000111111111111111000000000000000001111111000000000000000000000001000000022000000000111
1111111111111111111111111000000000111111110000000000000000000111111111111111100000000000000001111111000000000000000000000001000000220220000000111
1111111111111111111111110000000000011111100000000000000000000111111111111111110000000000000000111111000000000000000000000001000000000000220000011
1111111111111111111111100000000000000000000000000000000000001111111111111111110000000000000000211111100000000000000021110011000000000000022000001
1111111111111111111111000000000000000000000000000000000000001111111110000001110000000000000002221111111100000000000222111110000000000000000000001
1111111111111111111111000000000000000000000000000000000000001111111000000000000000000000000022222111111100000000000122211100000000000000022000001
1111111111111111111111000000000000000000000000000000000000001111110000000000000000000000000222222211111000000000000112222000000000000000002200001
1111111111111111111111000000000000000000000000000000000000000111000000000000000000000000002222222220110000000000000111222000000000000000022000001
1111111111111111111111000000000000000000000000000000000000000000000000000000000000000111122222222200000000000000000111220000000000000000000000001
1111111111111111111111000000000000000000000000111110000000000000000000000000000000001111112222222000000000000000001111000000000000000000000000001
1111111111111111111111000000000000000000000011111111000000000000000000000000000000001111111222220000000000000011111110000000000000000000000000001
1111111111111111111112000000000000000000000111111111100000000000000000000000000000011111111122200000000000000011111100000000000000000000000000001
1111111111111111111122200000000000000000001111111111110000000000000000000000000000111111111112000000000000000011111100000000000000000000000000001
1111111111111110111222220000000000000001111111111111110000000000000000111110000000111111111110000000000000000011111100000000000000000000000000011
1111111111101100112222222000000000000011111111111111110000000000000001111111000000111111111110000000000000000011111100000000000000000000000000111
1111111111000000022222222200000000001111111111111111110000000000000011111111000001111111111110000000000000000011111100000000000000000000000000111
1111111110000000002222222220000011111111100000011111111000000000000011111111000001111111111110000000000000000001111100000000000000000000000000111
1111111100000000000222222222001111111111000000001111111100000000000011111111000000111111111112000000000000000000111110000000000000000000000000111
1111111000000000000022222222211111111000000000001111111120000000000001111110000000011111111122200000000000000000000011110000000000000000000000011
1111110000000000000002222222111111110002200000000211111122000000000000111000000000001111111222220000000000000000000000011000000000000000000000001
1111110000000000000000222221111111100220220000000021111222211000000000000000000000001111112222222000000000000000000000001100000000000000000000001
1111111000000000000000022211111111002200000000000002222222111000000000000000000000000111122222221100000000000000000002200110000000000000000000011
1111111100000000000000002111111111022000000000000000222221111000000000000000000000000000002222211100000000000000000220220011000000000000000000111
1111111100000000000000000111111111000000000000000000022211111000000000000000000000000000000222111110000000000000000000022001000000000000000001111
1111111100000000000000000001111110022000000000000000002111111000000000000001111100000000000021111111111100000000000000002201000000000000001111111
1111111110000000000000000000111100220000000000000000000111111000000000000011111110000000000011111111111100000000000000000001100000000000001111111
1111111111110000000000000000111100022000000000000000000011111000000000011111111111000000000011111111111000000000000000002200110000000000001111111
1111111111111000000000000000111100000000000000000000000011111000000000111111111111100000000000111111111000000000000000000220011000000000011111111
1111111111111100000000000000011100000000000000000000000011111100000001111111111111100000000000001111111100000000000000002200001111000000111111111
1111111111111110000000000000001100000000000000000000000011111100000011111111111111110000000000001111111100000000000000000000000011100001111111111
1111111111111111000000000000001100000000000000000000000111111100000011111111111111110000000000000111111100000000000000000000000011111111111111111
1111111111111111000000000000001100000000000000000000002111111100000011111111111111110000000000000011111110000000000000000000000111111111111111111
1111111111100111000000000000000000000000000000000000022211111000000011111111111111110000000000000111111111000000000000000000001111111111111111111
1111111111000011000000000000000000000000000000000000222221111000000001111111111111000000000000000111111111000000000000000000001111111111111111111
1111111000000000000000000000000000000000000000000002222222111000000000000000000000000000000000000111111111000000000000000000001111111111111111111
1111110000000000000000000000000000000000000000000022222222211000000000000000000000000000000000000111111111100000000000000000011111111111111111111
1111110000000000000000000000000000000000000000000222222222000000000000000000000000000000000000000011111111111110000000000000111111111111111111111
1111110000000000000000000000000000000000000000111122222220000000000000000000000000000000000000000011111111111112000000000000111111111111111111111
1111100000000000000000000000000000000000001101111112222200000000000000000000000000000000000000000011111111111122200000000000011111111111111111111
1111000002200000000000000000000000000000011111111111222000000000000000000000000000000000000000000011111111111222220000000000011111111111111111111
1111000022000000000000000000000000001111111111111111120000000000000000000000000000000000000000000011111111112222222000000000111111111111111111111
1111000000000000000000000000000000001111111111111111110000000000000000000000000001111100000000000001111111122222222200000000111111111111111111111
1111000022000000000000000000000000001111111111111111110000000000000001111111111111111110000000000000000000002222222220000000111111111111111111111
1111000220000000000000000000000000011111111111111111000000000000000001111111111111111111100000000000000000000222222211110001111111111111111111111
1111000000000000000000000000000001111111111111111110000000000000000001111111111111111111110000000000000000000022222111111111111111111111111111111
1111000220000000000000000000000021111111111111111100000000000000000000111111111111111111110000000000000000000002221111111111111111111111111111111
1111000022000000000000000000000222111111111111111000000000000000000000011111111111111111111000000000000000000000211111111111111111111111111111111
1111000000000000000000000000002222211111111111110000000000000000000000001111111111111111111000000000000000000000111111111111111111111111111111111
1111000022000000000000000000022222221111110000000000000000000000000000000111111111111111111100000000000000000000111111111111111000000111111111111
1111100002200000000000000000222222222111000000000000000000000000000000000011111111111111111100000000000000000000111111111111110000000011111111111
1111110000000000000000000002222222220000000000000000000000000000010000000001111111111111111100000000000000000000001111111110000000000000011111111
1111110000000000000000000011222222200000000000000000000000000000111000000000111111111111111100000000000000000000002111111100000000000000001111111
1111110000000000000000001111122222000000000000000000000111111111111100000000011111111111111100000000000000000000022211111100000000000000000111111
1111111000000000000000001111112220000000000000000000001111111111111110000000001111111111111000000000000000000000222221111100000000000000000011111
1111111100000000000000001111111200000000000000000000001111111111111111000000000111000000000000000000000000000002222222110000000000000000000011111
1111111110000000000000011111111100000000000000000000001111111111111111100000000010000000000000000000000000000022222222200000000000000000000011111
1111111111110000000011111111111111000000000000000000001111111111111111110000000000000000000000000000000000111222222222000000000000000002200001111
1111111111111000000111111111111111000000000000000000001111111111111111111000000000000000000000000000000011111122222220000000000000000000220000111
1111111111111111111111111111111111000000000000000000000111111111111111111100000000000000000000000011111111111112222200000000000000000000000000111
1111111111111111111111111111111112000000000000000000000111111111111111111110000000000000000000000111111111111111222000000000000000000000220000111
1111111111111111111111111111111122200000000000000000000011111111111111111111000000000000000000001111111111111111120000000000000000000000022000111
1111111111111111111111111111111222220000000000000000000011111111111111111111100000000000000000011111111111111111100000000000000000000000000000111
1111111111111111111111100011112222222000000000000000000001111111111111111111100000000000000000111111111111111110000000000000000000000000022000111
1111111111111111111111000000022222222200000000000000000000011111111111111111100000000000000011111111111111111100000000000000000000000000220000111
1111111111111111111111000000002222222221111111100000000000001111100000000000000000000000000011111111111111111100000000000000000000000000000000111
1111111111111111111111000000000222222211111111110000000000000000000000000000000000000000000021111111111111111100000000000000000000000000220000111
1111111111111111111110000000000022222111111111110000000000000000000000000000000000000000000222111111111110000000000000000000000000000002200000111
1111111111111111111110000000000002221111111111110000000000000000000000000000000000000000002222211111101100000000000000000000000000000000000001111
1111111111111111111111000000000000211111111111110000000000000000000000000000000000000000022222221111000000000000000000000000000000000000000011111
1111111111111111111111000000000000011111111111110000000000000000000000000000000000000000222222222000000000000000000000000000000000000000000011111
1111111111111111111110000000000000000001111111111000000000000000000000000000000000000112222222220000000000000000000000000000000000000000000011111
1111111111111111111100000000000000000000111111111000000000000000000000000000000000000111222222200000000000000000000000000000000000000000000111111
1111111111111111111100000000000000000000111111111000000000000000111111111111100000000111122222000000000000000000000000000000000000110000111111111
1111111111111111111100000000000000000000111111111000000000000011111111111111110000000111112220000000000000000000000000000000000000111001111111111
1111111111111111111000000000000000000000011111110000000000000011111111111111110000001111111200000000000000000000001100000000000000111111111111111
1111111111111111110000000000000000000000001111111000000000000011111111111111110000001111111000000000000000000000001100000000000000111111111111111
1111111111100001110000000000000000000000001111111100000000000011111111111111110000001111110000000000000000000000001100000000000000011111111111111
1111111111000000111100002200000000000000001111111100000000000001111111111111100000001111110000000000000000000000001110000000000000001111111111111
1111111110000000000110022000000000000000000111111111000000000001111111111111000000000111110000000000000000000000001111000000000000000111111111111
1111111100000000000011002200000000000000000111111111110000000000111111111110000000000111110000000000000000000220001111000000000000000011111111111
1111111100000000000001100000000000000000001111111111110000000000011111110000000000000111111000000000000000000022001111000000000000000000011111111
1111111100000000000000102200000000000000001111111111120000000000001111100000000000000111111200000000000000000220011111100000000000000000001111111
1111100000000000000000100220000000000000000000011111222000000000000000000000000000000111112220000000000000000000111111111000000000000000001111111
1111000000000000000000110022022000000000000000001112222200000000000000000000000000000111122222000000000000000220111111111200000000000000001111111
1110000000000000000000011002200000000000000000001122222221111000000000000000000000000111222222200000000000002200111111112220000000000000000111111
1100000000000000000000001100000000000000000000000222222211111100000000000000000000000112222111120000000022022001111111122222000000000000000011111
1100000000000000000000000110000000000000000000000022222111111100000000000111000000000000221111112000000002200011111111222222200000000000000011111
1110000000000000000000000011110000000000000000000002221111111110000000011111100000000000021111111100000000000111111112222222220000000000000111111
1111000000000000000000000000011111000000000000000000211111111111000000111111110000000000001111111100000000111111111100222222222000000000001111111
1111000000000000000000000000001111100000000000000000011111111111100000111111110000000000000111111110000001111111110000022222222200000000011111111
1111000000000000000000000000001111110000000000000000011111111111100000111111110000000000000011111111111111111100000000002222222220000000111111111
1111000000000000000000000000001111110000000000000000011111111111000000111111100000000000000011111111111111110000000000000222222211001101111111111
1110000000000000000000000000001111110000000000000000011111111111000000011111000000000000000011111111111111100000000000000022222111011111111111111
1100000000000000000000000000001111110000000000000000211111111111000000000000000000000000000011111111111100000000000000000002221111111111111111111
1100000000000000000000000000001111110000000000000002221111111110000000000000000000000000000001111111111000000000000000000000211111111111111111111
1100000000000000000000000000011111110000000000000022222111111100000000000000000000000000000000111111110000000000000000000000111111111111111111111
1100000000000000000000000000111100000000000000000222222211111100000000000000000000000000000000011111000000000000000000000000111111111111111111111
1100000000000000000000000022111000000000000000002222222221111000000000000000000000000000000000000000000000000000000000000000111111111111111111111
1100000220000000000000000222111000000000000011022222222200000000000000000000000000111000000000000000000000000000000000000000111111111111111111111
1100002200000000000000000222211000000000000111112222222000000000000000000000000011111100000000000000000000000000000000000000111111111111111111111
1100000220000000000000001112221000000000001111111222220000000000000000000000000111111100000000000000000000000000000000000000111111111111111111111
1100000000000000000000011111222000000000001111111122200000000000000011100000011111111100000000000000000000000000000000000000111111111111111111111
1100000220000000000000110011120000000000000001111112000000000000000011111111111111111100000000000000000000000000000000000001111111111111111111111
1110000022000000000000100000000000000000000000111111000000000000000011111111111111111000000000000000000001111110000000000011111111111111111111111
1111000000022022000000100000000000000000000000111111100000000000000001111111111111111000000000000000000011111111000000000111111111111111111111111
1111000000000220000000100000000000000000000000111111100000000000000000111111111111111000000000000000000111111111100001111111111111111111111111111
1111000000000000000000100000000000000000000000011111100000000000000000011111111111111000000000000000001111111111111111111111111111111111111111111
1111100000000000000000100002200000000000000000001111100000000000000000011111111111110000000000000000001111111111111111111111111111111111111111111
1111110000000000000000100022000000000000000000001111102200000000000000001111111111110000000000000000001111111111111111111111111111111111111111111
1111111000000000000001100002200000000000000000001111122000000000000000001111111111110022000000000000001111111111111111111111111111111111111111111
1111111111000000001111000000000000000000000000001111102200000000000222001111111111110220000000000000000111111111111111111111111111111111111111111
1111111111100000011111000002200000000000000000011111100000000000000222001111111111110022000000000002220011111111111111111111111111111111111111111
1111111111111111111111000000220000000000000000111111102200000000000222011111111111110000000000000002220011111111111111111111111111111111111111111
1111111111111111111111100000000220220000000000111111110220000000000000011111111111111022000000000002220011111111111111111111111111111111111111111
1111111111111111111111110000000002200000000000111111110000220220222000011111111111111102200000000000000111111111111111111111111111111111111111111
1111111111111111111111110000000000000000000001111111110000002200222000011111111111111110002202202220001111111111111111111111111111111111111111111
1111111111111111111111110000000000000000000011111111111000000000222000111111111111111111000022002220011111111111111111111111111111111111111111111
1111111111111111111111111000000000000000000111111111111100000000000011111111111111111111111000002220111111111111111111111111111111111111111111111
1111111111111111111111111111000000000000111111111111111111111111111111111111111111111111111100000011111111111111111111111111111111111111111111111
1111111111111111111111111111100000000001111111111111111111111111111111111111111111111111111111111111111111111111111111111111111111111111111111111
1111111111111111111111111111111111111111111111111111111111111111111111111111111111111111111111111111111111111111111111111111111111111111111111111
1111111111111111111111111111111111111111111111111111111111111111111111111111111111111111111111111111111111111111111111111111111111111111111111111
1111111111111111111111111111111111111111111111111111111111111111111111111111111111111111111111111111111111111111111111111111111111111111111111111
