000000000000222222222222222222222222222222222222222222222000000000000000000000000000000000000000
000000000002222222222222222222222222222222222222222222220000000000000000000000000000000000000000
000000000022222222222222222222222222222222222222222222200000000000000000000000000000000000000000
000000000000022222222222222222222222222222222222222222200000000000000000000000000000000000000000
000000000000222222222222222222222222222222222222222220200000000000000000000000000000000000000000
000000000002222222222222222222222222222222222222222202200000000000000000000000000000000000000000
000000000022222222222222222222222222222222222222222222222200000000000000000000000000000000000000
000000000002222222222222222222222222222222222222222222222000000000000000000000000000000000000000
000000000022222222222222222222222222222222222222222222222000000000000000000000000000000000000000
000000000022222222222222222222222222222222222222222222222220020000000220022000000000000000000000
000000000222222222222222222222222222222222222222222222222222222200002222222200000000000000000200
000000002222222222222222222222222222222222222222222222222222222220022222222220000000000000000220
000000000222222222222222222222222222222222222222222222222202200222222002222222022000000000022222
000000002222222222222222222222222222222222222222222222220000000000000000022222222200000002222222
000000000022222222222222222222222222222222222222222222210000000000000000000222222220002222222222
000000000002222222222222222222222222222222222222222200000000000000000000000022220220110222222222
000000000022222222222222222222222222222222222222222200000000000000000000000002200220110222222222
000000000000222222222222222222222222222222222222222220000000000000000000000002202220002222222222
000000000000222222222222222222222222222222222222222220000000000000000000000000002222222222222222
000000000002222222222222222222222222222222222222222222000000000000000000000000022222222222222222
000000000002222222222222222222222222222222222222222222200000000000000000000000222022222222222222
000000000002222222222222222222222222222222222222222222200000000000000000000000022222222222222222
000000000002222222222222222222222222222222222222222220000000000000000000000000022222222222222222
000000000000022222222222222222222222222222222222222200000000000000000000000000000222222222222222
000000000000002222222222222222222222222222222202220000000000000000000000000002222233222222222222
000000000000000222222222222222222222222222222000000000000000000000000000000022222233222222222222
000000000000000222222222222222222222222222222200000000000000000000000000000022222222222222222222
000000000000000002222222222222222222222222220000000000000000000000000000000222222222222222222222
000000000000000000022222222222222222222222200000000000000000000000000000000222222222222222222222
000000000000000000000000222222222222222222200000000000000000000000000000000022222223222222222222
000000000000000000000000002222222202222220000000000000000000000000000000200222222222222222222222
000000000000000000000000000022220000022000000000000000000000000000000002222222220222222222222222
000000000000000000000000000000000000000000000000000000000000000000000022222222222222222222222222
000000000000000000000000000000000000000000000000000000000000000000000000222222222222222222222222
000000000000000000000000000000000000000000000000000000000000000000000000022222222222222222222222
000000000000000000000000000000000000000000000000000000000000000000000200222222222222222222222233
000000000000000000000000000000000000000000000000000000000000000000022222222222222222222222222222
000000000000000000000000000000000000000000000000000000000000000002222222222202222222222222222222
000000000000000000000000000000000000000000000000000000000000000002222222222222222222222222222222
000000000000000000000000000000000000000000000000000000000000000022222222222222222222222222222222
000000000000000000000000000000000000000000000000000000000000000002222222200222222222222222222222
000000000000000000000000000000000000000000000000000000000000000002200220000022222222222222222222
000220000000000000000000000000000000000000000000000000000000000000000000000000222222222222222222
022222200220001100000000000000000000000000000000000000000000000000000000000000002222222222222222
222222222222201100200000000000000000000000000000000000000000000000000000000000000022222222222222
223322222222220002200000000000000000000000000000000000000000000000000000000000000000222222222222
333322222222222222222200000000000000000000000000000000000000000000000000000000000000002222222222
332222222222222222222000000000000000000000000000000000000000000000000000000000000000000022222222
222222222222222222222000000000000000000000000000000000000000000000000000000000000000000000222222
222222222222222222222200000000000000000000000000000000000000000000022000000000000000000000002222
222222222222222222222220000000000000000000000000000000000000000000222000000000000000000000001222
222222222222222222222222000000000000000000000000000000000000000011022200000000000000000000000000
222222222222222222222220000000000000000000000000000000000000000011222220000000000000000000000001
222222222222222222222222000000000000000000000000000000000000022002222220000000000000000000000001
222222222222222222222222000000000000000000000000000000000000022222222220000000000000000000000000
222222222222222222222222200000000000000000000000000000000000222222222222000000000000000000020000
222222222222222222222222200000000000000000000000000000000000002222222200000000000000000000022000
222222222222222222222220000000000011000000000000000000000000000022220000000000000000000022222220
222222222222222222222220000000000011000000000000000000000000000000000000000000000000000002222222
222222222222222222222220000000000000000000000000000000000000000000000000000000000000000002222222
222222222222222222222000000000000000000000000000000000000000000000000000000000000000000022222222
222222222222222222220011000000000000000000000000000000000000000000000000000000000000002222222222
222222222222222222111111000000000000000000000000000000000000000000000000000000000000022222222222
222222222222222220111100000000000000000000000000000000000000000000000000000000000000222222222222
222222222222222222000000000000000000000000000000000000000000000000000000000000000002222222222222
222222222222222220000000000000000000000000000000000000000000000000000000000000000222222222222222
222222222222222222000000000000000000000000000000000000000000000000000000000020022222222222222222
222222222222222200000000000000000000000000000000000000000000000000000000000222222222222222222222
222222222202220000000000000000000000000000000000000000000000000000000000000222222222222222222222
222222220011000000000000000000000000000000000000000000000000000000000000110222222222222222222222
222222210011000000000000000000000000000000000000000000000000000000000011110222222222222222222222
022000000000000000000000000000000000000000000000000000000000000000000011022222222222222222222222
000000000000000000000000000000000000000000000000000000000000000000000000222222222222222222222222
000000000000000000000000000002200000000000000000000000000000000000000002222222222222222222222222
000000000000000000000000000022222000000000000000000000000000000000000002222222222222222222222222
000000000000000000000000000222222200000000000000000000110000000000000002222222222222222222222222
110000000000000000000000000222222220000000000000000000110000000000000002222222222222222222222222
110000000000000000000000000222220220000000000000000000000000000000000000222222222222222222222222
002000000000000000000000000222200000000000000000000000000000000000000000022222222222222222222222
022000000000000000000000000022201100000000000000000000000000000000000000022222222222222222222222
222220000000000000000000000002201100000000000000000000000000000000000000002222222222222222222222
222222200000000000000000000002200000000000000000000000000000000000000000000022222222222222222233
222222222000000000000000000000000000000000000000000000000000000000000000000012222222222222222233
222222222220000000000000000000000000000000000000000000000000000000000000000000000222222222222222
222222222222200000000000000000000000000000000000000000000000000000000000000000001122222220022222
222222222222222000000000000000000000000000000000000000000000000000000000000000001102222200002222
222222222222222220000000000000000000000000000000000000000000000000000000000000000022220000000000
222222222222222222220000000000000000000000000000000000000000000000000000000000000000000000000000
222222222222222222200002200000000000000000000000000000000000000000000000000000000000000000000000
222222222222222222200222222220000000000000000000000000000000000000000000000000000000000000000000
222222222222222222222222222222020000000000000000000000000000000000000000000000000000000000000000
222222222222222222222222222222222000000000000000000000000000000000000000000000000000000000000000
222222222222222222222222220222222200000000000000000000000000000000000000000000000000000000000000
222222222222222222222222222222220000000000000000000000000000000000000000000000000000000000000000
222222222222222222222222222222000000000000000000000000000000000000000000000000000000000000000000
222222222222222222202222022200000000000000000000000000000000000000000000000000000000000000000000
332222222222222222022222000000000000000000000000000000000002200000000000000000000000000000000000
222222222222222222222222200000000000000000000000000000000022222002200000000000000000000000000000
222222222222333222222202200000000000000000000000000000022222222222222000200220000000000000000000
222222222222332222222000000000000000000000000000000000222222222222222222222222200000000000000000
222222222222222222222200000000000000000000000000000002222222222222222222222222220000000000000000
222222222222222222222000000000000000000000000000000022222222222222222222222222222000000000000000
222222222222222222222000000000000000000000000000000022222222222222222222222222222200000000000000
222222222222222222220000000000000000000000000000000222222222222222222222222222222220000000000000
222222222222222222200000000000000000000000000000202222222222222222222222222222222222000000000000
222222222222222202200000000000000000000000000022222222222222222222222222222222222222200000000000
222222222222222220000000000000000000000000002222222222222222222222222222222222222222220000000000
222222222222222220000000000000000000000000222222222222222222222222222222222222222222200000000000
222222222222222220000000000000000000000002222222222222222222222222222222222222222222220000000000
222222222222222220000000000000000000000002222222222222222222222222222222222222222222220000000000
222222222222222220000000000000000000000000222222222222222222222222222222222222222222222000000000
222222222220222200000000000000000000000000022222222222222222222222222222222222222222222200000000
222222222211022002200000000000000000000002022222222222222222222222222222222222222222222200000000
222222220011222222220000000000000000000002202222222222222222222222222222222222222222222220000000
222222000000022222222000000000000000002222222222222222222222222222222222222222222222222222000000
222200000000022222222220000000000000000222222222222222222222222222222222222222222222222200000000
222100000000000220222222200200000002200222222222222222222222222222222222222222222222200000000000
000000000000000000022222222222222222222222222222222222222222222222222222222222222222220000000000
000000000000000000022222222220002222222222222222222222222222222222222222222222222222222000000000
000000000000000000000220022000000220022222222222222222222222222222222222222222222222222000000000
000000000000000000000000000000000000002222222222222222222222222222222222222222222222222000000000
000000000000000000000000000000000000000022222222222222222222222222222222222222222222222200000000
000000000000000000000000000000000000000012222222222222222222222222222222222222222222220000000000
000000000000000000000000000000000000000000002222222222222222222222222222222222222222200000000000
000000000000000000000000000000000000000000022222222222222222222222222222222222222222220000000000
000000000000000000000000000000000000000000222222222222222222222222222222222222222220000000000000
000000000000000000000000000000000000000002222222222222222222222222222222222222222220000000000000
000000000000000000000000000000000000000022222222222222222222222222222222222222222220000000000000
