111111111111110000000000000000000000000000000000000011111100000000000000000000000000000000000000
111111111111110000000000000000000000000000000000000011110000000000000000000000000000000002200000
111111111111111100000000000000022220000000000000000011110000000000000000000000000000000220220000
111111111111111100000000000220022220000000000000001111110000000000000000000000000000000000000220
111111111111110000000000002200000000000000000000111111102220000000000000000000000000000000000000
111111111111110000000000000000000000000000000000111111120020000000000000000000000000000000000220
111111111111110000000000002200000000000000000000001111220110000000000000000000000000000000000022
111111111111110000000000022000000000000000000000000022211100000000000000000000000000000000000000
111111111111110000000000022000000000000000000000000022211100000000000000000000000000000000000000
111111111111000000000000002200000000000000000000000022221111111100001111111100000000000000001000
111111111111000000000000000000000000000000000000000022211111111112211111111112000000000000000122
111111111111000000000000002200000000000000000000000022211111111111111111111111000000000000002111
111111111111000000000000002200000000000000000000000011221111111111111111111111111100000000200211
111111111111110000000000000220000000000000000000001111102220000000000000111111111112000020022222
111111111111110000000000000000000000000000000000111111110020000002200000001111111111011002222222
111111111111110000000000000000000000000000000000111111110200000220222200000011111111111112222222
111111111111111100000000000000000000000000000000001112002200000000000000000011111111111112222200
111111111111111100000000000000000000000000000000001111000000000000000022000011111111111122220000
111111111111110000000000000000000000000000000000001111000000000000000002200000211111110000000000
111111111111110000000000000000000000000000000000000011120000000000000002200000111111110000000000
110000000011110000000000000000000000000000000000000011110000000000000022000000111111110000000000
000000000011110000000000000000000000000000000000001111110000000000000000000000111111000000000000
000000000011111100000000000000000000000000001111111111000000000000000022220000111111000000000000
000002202222111111000000000000000000000000111111111111002200000000000022220021111111000000000000
000220220220221111000000000000000000000000111111111111112222000000000000000011111111000000000000
000000000000001111000000000000000000000000111111111111112222000000000000000011111111000000000000
000000000000001111111111000000000000000011111111111112222211000000000000002111111111000000000000
000000000000000011111111110000000000000011111111111222221111110022000000001111111111000000000000
000000000000000000111111111100211111000011110011122222111111111122220000001111111111000000000000
222200000000000000111111111111111111111111110022222211111111111122220000001111111111000000000000
222200000000000000111111111111111111111111000022222111111111122222110021111111111111000000000000
000000000000000000001111111111111200111100000000222211111112222211111111111111111111000000000000
000000000000000000001111111111110000110000000000000000111222221111111111111111111100000000000000
000000000000000000001111111111110000000000000000000000222222111111111111111111110000000002222000
000000000000000000001111111100000000000000000000000000222221111111111111111111000000000002222011
000000000000000000111111111100000000000000000000000000002222111111111111111111000000000000000011
000000000000000022111111110000000000000000000000000000000000001111111111111111110000000000000000
001111000000111122222111000000000000000000000000000000000000000021111111111111110000000000000220
111111111111111111222222000000000000000000000000000000000000000011111111111111000000000000000220
111111111111111111122222000000000000000000000000000000000000000011111111111111122200000000000022
111111111111111111222200000000000000000000000000002222000000000011111111111111122222000000000022
111111111111111100000000000000000000000000000000222222220000000011111111000011222222220000000220
111111111111110000000000000000000000000000000000222222220022220000000000000022002222222200000022
111111111111111100020000000000000000000000000000002222002222220000000000000200220022222222000220
112200111111111122102220000000000000000000000000000000002222220000000000000020002200222222220000
221100000000111111120020000000000000000000000000000000000022222200000000000002200022002222222200
111100000000001111200110002222000000002222000000000000000022222222000000000000022000220022222222
110000000000000022211100222222220000222222000000000000000022222222000000000000000220002200222222
000000000000000022211100222222222200222200000000000000222222222200211200000000000002200022002211
000000000000000000221112002222222222222200000000000022222222222200111100000000000000022000220111
000000022220000000001111002222222222222222000000000022220000222222111100000000000000000220001111
000220022220000000001111002222222200222222000000000000000000000011111112000000000000000002201111
002200000000000000001111002222222222222200000000000000000000000011111111110000000000000000020011
022000000000000000001111002222222222220000000000000000000000211111111111110000000000000000000011
002200000000000000000011120022220000000000000000000000000000111111111111110000000000000000200000
002200000000000000000011110000000000000000000000000000000011111111111111110000000000000222012200
022000000000000000001111110000000000000000000000000022221111111111111111111000000000000200211100
002200000000000000001111000000000011000000000000002222221111111111111111111120000000000110021111
000000000000000000211111000000000011000000000000002222222221111111111111122222200000000011122211
000000000000000000111111000000000000000000000000001122222222211111111112222222221100000011122200
000000000000000011111100000000000000000000000000111111222222222111111222222222111111001111220000
000000000000001111112211000000000000000000222211111111112222222222222222222211111111111111000000
000000000000001111111111000000000000000022222211111111111122222222222222221111111111111100000000
000000000000001111111100000000000000000022222222211111111112222200002222211111111111111100000000
000000000000001111000000000000000000000011222222222111111122220000000022221111111111110000000000
000000001100001111111100220000000000001111112222222221110000000000000000001111111111000000000000
000000211111111111111111222200002222111111111122222222220000000000000000002111111100000000000000
000022211111111111111111222222222222111111111111222222220000000000000000001111110000000000000000
110011221111111111111222222222222222222111111111122222000000000000000000001111000000000000000000
111111102211111111122222222211112222222221111111222200000000000000000000111111000000000000000000
111111110011001112222222221111111122222222211100000000000000000000000011111111000000000000002200
111111110200000002222222111111111111222222222200000000000000000000000011111100000000000000000220
120000002200000000022211111111111111112222222200000000000000000000000021110000000000000000002200
110000000000000000000111111111111111111222220000000000000000000000000011110000000000000000000220
110000000000000000000211112111111111112222000000000000000000000000000011110000000000000000002200
220000000000000000000000001111111112110000000000000000110000000000000011110000000000000000002200
110000000000000000000000001111111111110000000000000000110000000000000011111100000000022220022000
110200000000000000000000001111111111000000000000000000000000222200000000111100000000022220000000
221022000000000000000000001111112200002222000000000000000022222200222200111112000000000000000000
111200220000000000000000000011111100222222220000000000002222222222222222111112220000000000000000
112002002200000000000000000011111100222222220000000000222222222222222222221122110000000000000022
222220020022000000000000000011110000002222220000000000222222222222222222222201111100000000000011
222222200200220000000000000000000000000022222200000000000000222222222222020011111111000011111211
222222222002002200000000000000000000222200222200000000000000002222000000022011111111111111111111
002222222220020022000000000000000000222222000000000000000000000000000000000200001111111111111111
000022222222200200220000000000000000222222000000000000000000000000000000000000001111111111111111
022000222222222002002000000000000022222222000000000000000000000000000000000000001111111111111111
220000002222222220011000000000000022222222000000000000002222000000000000002200111111111111111111
022000000022222221110011111112000000222200000000000000222222220000000000222211111111111111111111
220000000000222221111111111111000000000000000000000000222222220000000000222211111111111111111111
220000000000002222111111111111111200000000000000000000222222000000000000112222211100000000111100
022000000000000000111111111111111100000000000000000000222200000000000011111122220000000000000000
022000000000000000111111111111111111002200000000000000000000000000001111111112000000000000000000
000000000000000000111111111111111111112222000000000000000000000000001111111100000000000000000000
000222200000000011111111111111111111112222000000000000000000000000001111110000000000000000000000
110222200000001111111111111111111112222211000000000000000000000000111111110000000000000000000000
110000000000001111111111111111111222221111110022000000000011110000111111111100000000000000002222
000000000000001111111111110011122222111111111122220000001111111111111111111100000000000000002222
000000000000111111111111110022222211111111111122220000111100001111111111111111000000000000000000
000000000000111111111100000022222111111111122221100021110000000000001111111111110000000000000000
000000000000111111111100000000222211111112222111111111110000000000000000000000111200000000000000
000000000011111111111100000000000000111222211111111111110000000000000000000000111100000000000000
000000000011111111111100000000000000222221111111111111000000000000000000000000111122022002222000
000000000000111111110000000000000000222211111111111111000000000000000000000000001111222222000000
000000000000111111110000000000000000002222111111111111000000000000000000000000000011120000000000
000000000000111111110000000000000000000000001111111100000000000000000000000000000011110000000000
000000000000111112000022220000000000000000111100000000000000000000000000000000000011110000121111
000000000011111111000022220000000000000021110000000000000000000000000000000000000011110000111111
000000000011111111000000000000000000000011110000000000000000000000000000000000000011110011111111
000000000011111111000000220000000000000011111100000000000000000000000000000000000000111211111111
000022211111111111000002200000000000000000111100000000000000000000000000000000000000111111111111
002222211111111111120000220000000000000000111100000000000000000000000000000000000000111111111111
222222221111111111110000220000000000002201111111000000000000000000000000000000000000001111111111
222222002211111111110000000022022000020021111111000000000000000022220000000000000000001111111111
112200220000111111111100000222200000011002111100000000000000000022220000000000000000111111111111
111022000000111111111111000000000000001112220000000000000000000000000002200000000011111111111111
111100000000001111111111111112211111111112220000000000000000000000000000000000000011111111111111
111100000000000000111111111111111111111122220000000000000000000000000002200000000000111111111111
000000000000000000111111111111211111111112220000000000000000000000000000220000000000111111111111
000000000000000000001111111100001111111112220000000000000000000000000000220000000000111111111111
022000000000000000000000000000000000001122110000000000000000000000000002200000000000111111111111
220000000000000000000000000000000000002201111100000000000000000000000000220000000011111111111111
022000000000000000000000000000000000020011111111000000000000000000000002200000000011111111111111
000000000000000000000000000000000000022011111111000000000000000000000002200000000011111111111111
022000000000000000000000000000000000000200111100000000000000000000000022000000001111111111111111
002202200000000000000000000000000000000021110000000000000000000000000000000000001111111111111111
111110000000000000000000000000000000000011110000000000000000000000000000000000001111111111111111
111111111111111111111111111111111111111111111111111111111111111111111111111111111111111111111111
