00000000000000000021111111000000000000000011111111111111000000000000001111111111112111000000000000000011111112000000000000000000
00000002222000000000211111110222200022000000111211111111110000000000001111111111111111000022000222201111111200000000022220000000
00000002222000000000002111110222202202200000111111111111110000000000002211111111111111000220220222201111120000000000022220000000
00220000000000000000000011110000000000220011111111111111110000000000001111111111111111000000000000001111000000000000000000002200
00220000000000000000000011110000000000000011111111111111110000022000001111111111111111002200000000001111000000000000000000002200
02200000000000000000000011110000000000220000111211111111110000000000000011111111211100022000000000001111000000000000000000000220
00220000000000000000000001110000000000022000111111111111110000000000000011111111111100002200000000001110000000000000000000000220
02200000000000000000000001110000000000022011111111111111000000000000000011111111111111022000000000001110000000000000000000002200
02200000000000000000000000000000000000000011121111111100220000000000000000111111111111002200000000000000000000000000000000002200
02200000000000000000000000000000000000220011111111111100000000000000002200111111111111000000000000000000000000000000000000000220
00220000000000000000000000000000000000000011111111111111022000000000022011111111111111000000000000000000000000000000000000002200
00220000000000000000000011110000000000000000111211111111002200222202200011111111211100000000000000001111000000000000000000002200
00000000000000000000001111110000000000000000111111111111000000222200000011111111111100000000000000001111110000000000000000000000
00000000000000000000001111110000000000000011111111111111111100000000000011111111111111000000000000001111110000000000000000000000
00000000000000000000002111111100000000001111111111111121111111111111110011111111111111110000000000111111110000000000000000000000
00000000000000000000000021111111000000001111111111111111110011111111111111111111111111110000000011111112000000000000000000000000
00000000000000000000000000211111000000001111111111111111110000000000001112111111111111110000000011111200000000000000000000000000
00000000000000000000000000001111000000001111111111111111110000000000001111111111111111110000000011110000000000000000000000000000
00000000000000000000000000001111000000000011111111111111111100000000111111111111111111000000000011110000000000000000000000000000
00000000000000000000000000001111000000000000111211111111111100000011111111111111111100000000000011110000000000000000000000000000
00000000000000000000000000111111000000000000111111111111111111111111111111111121110000000000000011111100000000000000000000000000
00000000000000000000000011111111000000000000111111111111111111111111111111111111110000000000000021111111000000000000000000000000
00000000000000000000001111111200000000000000001111111111111111111111111111111111110000000000002222211111110000000000000000000000
00000000000000000000001111120000000000000000000011111111111111111111111111111111000000000000002222222111110000000000000000000000
00000000000000000000001111220000002222000000000000111211111111111111111111111100002222000000000022222211110000000000000000000000
00000000000000000000111111212222002222000000000000111111111111111111111121110000002222002222000000002111111100000000000000000000
00000000000000000011111111222222220000000022220000111111111111111111111111110000002222222222000000000011111111000000000000000000
00000000000000000011111200222222220022222222220000001111111111111111111111110000222222222222000000000000211111000000000000000000
00000011110000000011112200000000002222222222000000000011121111111111112111100000222222002222002222000000001111000000001111000000
11111111111100001111111100000000222222221200000000001011111111111111111111000000002222221200002222000000221111110000111111111111
11111111111111111111110000000000222222222222220000000011111111111111111111000000002222220000000000222200211111111111111111111111
11111112211111111112000022220000222200222222220000000011111111111111111111000000002222002222222222222222000021111111111221111111
12211200002111111200000022220022222222222222000000000011111111111111111111000000000000002222222222222222000000211111120000211221
00000000000021120000000000000022222222222200000000002111112211111111001111122200000000000022220011000000000000002112000000000000
00000000000000000000000000222200000000000000000000002111111200000000001111122200000000000000000000000000000000000000000000000000
11111111110000000000000000222222210000000000000000222211000000000000001211222200000000000000000000000000000000000000001111111111
11111111111111110000000000002222000000000000002222222222000000000000000022222222000000000000000000000000000000001111111111111111
11111111111111111112220000000000000000000000222222222222000000222200000022222222222220000000000000000000002221111111111111111111
00000000001111111112220000000022220000002222222222222222000022222222000022222222222222200000000000000000002221111111110000000000
02222000000000001122110000000022220000002222222222222200002222222222220000222222222222222000000000000000001122110000000000022220
02222000000000002221111100000000000000222222222222220000222222222222222200002222222222222220000000000000111112220000000000022220
00000000000000002211111111000000000022222222222222000022222222222222222222000022222222222222200000000011111111220000000000000000
00000000000000000211111111000000002222222222222200002222222222222222222222220012222222222222222000000011111111200000000000000000
00220000000000000000221111000000222222222222221200222222222222222222222222222200002222222222222220000011112200000000000000002200
00022000000000000000111111110022222222222222000022222222222222222222222222222222000022222222222220001111111100000000000000022000
00000000000000000000110011111111222222222200002222222222222222222222222222222222220000222222222211111111001100000000000000002200
00022000000000000000112111111111122222220000222222222222222222222222222222222222222200002222222111111111121100000000000000000000
00022000000000000000111111111111112222000022222222222222222222222222222222222222222222000022221111111111111100000000000000022000
00002200220000000011111111110011112200002222222222222222222222222222222222222222222222220000221110110011111100000000022022220000
00000002222000000011111111000000000000222222222222222222222222222222222222222222222222222200000000000011111200000000000220000000
00000000000000000021111111000000000022222222222222222222222222222222222222222222222222222222000000000011111111000000000000000000
00000000000000000011111111000000000111222222222222222222222222222222222222222222222222222211100000000011111111110000000000000000
00000000000000000011111100000000000011122222222222222222222222222222222222222222222222222111000000000011111111110000000000000000
00000000000000210011111111120000000011122222222222112222222222222222222222221122222222222111000000000011111111120000000000000011
00000000000022211111111111112200002111222222222211111222222222222222222222211111222222222211120000000011112211110012000000000000
00000000000111221111002211111100001111122222222111111122222222222222222222111111112222222111110000001111221111111112220000000000
11111100000011122200001111111200001111122222221111211122222222222222222222111211112222222111110000211100110000111122111000000011
11111111111111122200000021111100001211222222211111222222222222222222222222221111111222222211000000111112110000002221110011111111
00000011111111222200000021111100000022222222211111222222222222222222222222221111111222222222000000111112000000002221111111111100
00000000000000000000000022110000000022222222221122222222222222222222221122222222112222222222000000001122000000002222111100000000
00000000000000000000000022220000000022222222222222222222112222222222222122222222222222222222000000002222000000000000000000000000
00000000000000000000110022220000000022222222222222222222112222222222222222222222222222222222000000002222001100000000000000000000
11000000220000000000000022220000000022222222222222222222222222222222222222222222222222222222000000002222000000000000000000000000
11000000210000000000000022220000120022222222222222222222222222222222222222222222222222222222000000002222000000220000000000000000
11000000110000000000000022220000000022222222222222222222222222222222222222222222222222222222000012002222000000210000000000000000
00000000000000000000000022220000000022222222222222222222222222222222222222222222222222222222000000002222000000000000000000000000
00000000000000000000000022220000000022222222222222222222222222222222222222222222222222222222000000002222000000000000000000000000
00000000000000000000000022220000000022222222222222222222222222222222222222222222222222222222000000002222000000000000000000000000
00000000000000000000000011120000000022222222111222222222222222222222222222222222211122222222000000002111000000002221111100000000
00000011111111122200002211120000000022222222111222222222222222222222222222222222211122222222000000002111000000002221111111111111
11111111111111122200001111111200000021112222221112112222222222222222112222221121112222221112000000211100000000001122111111111111
11111111111111221100001111111100000021112222221112111222222222222222112222211111112222221112000000111100000000111112220011111111
11111100000022211111111111111100002111222222221111111222222222222222222222211111112222222211120000111111110011111111220000000000
00000000000022111111111111110000001111122222222211112222222222222222222222221111222222222111110000111111110011111111200000000000
00000000000002111111111111220000001111122222222222222222222222222222222222222222222222222111110000002221111111110000000000000000
00000000000000002211111222000000000011222222222222222222222222222222222222222222222222222211000000001111111111110000000000000000
00000000000000001111111111000000000022222222222222222222222222222222222222222222222222222222000000000011111111000000000000000000
00000000000000001100211111000000000022222222222222222222222222222222222222222222222222222222000000001111111100000000000000000000
00000000000000000011111111000000000022222222222222222222222222222222222222222222222222222222000000000011111100000000000000000000
00000002200000000011111111000000120002222222222222222222222222222222222222222222222222222200002100002111112112000000022022000000
00002200222200000011111111000011122200022222222222222222222222222222222222222222222222220000222111001111112111000000220002200000
00022000000000000011111111111111222222000022222222222222222222222222222222222222222222000022222211111111221100000000000000022000
00022000000000000011111111111122222222220000222222222222222222222222222222222222222200002222222222111111111100000000000000000000
00000000000000000000110011110022222222222200002222222222222222222222222222222222220000222222222222001111110000000000000000022000
00220000000000000000002111000000222222222222000022222222222222222222222222222222000022222222222222000011121200000000000000002200
00022000000000000021001111000000222222222222220000222222222222222222222222222200002222222222222200000011110012000000000000022000
00000000000000002221111111000000002222222222222200122222222222222222222222221200222222222222220000000011111112220000000000000000
00000000000000011122111100000000000022222222222222000022222222222222222222000022222222222222000000000000111122111000000000000000
02222000000000001112220000000000000000222222222222220000222222222222222200002222222222222200000000000000002221110000000000022220
02222000000000001112220000000000000000002222222222222200002222222222220000222222222222220000000000000000002221110000000000022220
00000000001111111122220000000000000000000022222222222222000022222222000022222222222222000000002222222200002222111111110000000000
11111111111111110000000000002222000000000000222222222211100000222200000111222222222200000000222222222200000000001111111111111111
11111111110000000000000000002222220000000000002222222111000000000000000011122222220000000000222222220000000000000000001111111111
00000000000000000000000000122222220000000000000022222111000000000000000011122222000000000000002222000000000000000000000000000000
00000000000000000000002222222222220000222200000000222211120011111111002111222200000000000000001200222200000000000000000000000000
00000000000011110000002222222222222222222200000000000011111111111111111111100000000000000000222222222222000000001111000000000000
11111100001111111100000022222200222222222200000000000011111111111111111111000000000000000022222222222222000000111111110000111111
11111111111111111111000000222200222222222222222200000011111111111111111111000000000022220022222222222200000011111111111111111111
11111111111112211111110000000000222222222222222200000011111111111111111111000000002222220000000000000000001111111221111111111111
21122111111200002111112200000000002222110022220000000011111111111111111111000000002222000000222200000000221111120000211111122112
00000021120000000011112100222222220000222200000000101111111111111111111111110000000000222200222200000000111111000000002112000000
00000000000000000011111100222222220022222200000000111111111111111111111111111100000000222222001100000000111111000000000000000000
00000000000000000011111111002222000022220000000000111111111111111111111111211100000000002222000000000011111112000000000000000000
00000000000000000000211111222222000022220000000000111111111111111111111111111100000000000000222222222211111200000000000000000000
00000000000000000000001111112222220022220000000011111111111111111111111111111111000000222222222222221111110000000000000000000000
00000000000000000000001111110022220000000000001111111111111111111111111111111111110000222222222222001111110000000000000000000000
00000000000000000000002111111100000000000000001111111111112111111111121111111111110000000000000000111111110000000000000000000000
00000000000000000000000021111111000000000000001111111111111111111111111111111111110000000000000011111112000000000000000000000000
00000000000000000000000000211111000000000000111111111111111111000011111111111111111100000000000011111200000000000000000000000000
00000000000000000000000000001111000000000011111111111111111100000000111111111111111111000000000011110000000000000000000000000000
00000000000000000000000000001111000000001111111111111121110000000000001112111111111111110000000011110000000000000000000000000000
00000000000000000000000000001111000000001111111111111111110000000011111111111111111111110000000011110000000000000000000000000000
00000000000000000000000000111111000000001111111111111111111111111111111111111111111111110000000011111100000000000000000000000000
00000000000000000000000011111112000000001111111111111100111111111111111111111111111111110000000021111111000000000000000000000000
00000002222000000000000011111200000000000011111111111111221111111100000011111111111111000000000000211111000000000000022220000000
00000002222000000000000011110000000000000000111211111111110000000000000011111111211100000000000000001111000000000000022220000000
00220000000000000000000001110000000000022000111111111111110000222200000011111111111100000000000000001110000000000000000000002200
00220000000000000000000001120000000000000011111111111111000220222200220011111111111111002200000000001110000000000000000000002200
02200000000000000000000000000000000000220011111111111111022000000000022000111111111111000000000000000000000000000000000000000220
00220000000000000000000000000000000000220000111211111111000000000000000000111111111111002200000000000000000000000000000000002200
02200000000000000000000000000000000000022000111111111111022000000000002211111111111111022000000000000000000000000000000000002200
02200000000000000000000011110000000000000000111111111111110000000000001111111111211100002200000000001111000000000000000000000220
00220000000000000000001111110000000000022000111111111111110000022000001111111111111100000000000000001111110000000000000000000220
00220000000000000000001111120000000000220011111111111111000000000000000011111111111100002200000000001111110000000000000000002200
00220000000000000000001111000222200022000011111111111111000000000000000011111111111100000220220222200011110000000000000000002200
00000000000000000000001111000222200220000011111111111111220000000000002211111111111111000002200222200011110000000000000000000000
11111000000000000000001111000000000000001111111111111111110000000000001111111111111111000000000000000011110000000000000000011111
11111111111111111111111111111111111111111111111111111111111111111111111111111111111111111111111111111111111111111111111111111111
