22222222222222222222444422222222222222222222000000000000000000000000000000000000000022222222222222222222444422222222222222222222
22222222222222222222224444422222222222222222220000000000000000000000000000000000000222222222222222222444442222222222222222222222
22222222222222222222222244422222222222222222222000000000000000000000000000000000000222222222222222222444222222222222222222222222
22222222222222222222222224422222222222222222220000000000000000000000000000000000000222222222222222222442222222222222222222222222
22222222222222222222222224422222222222222222220000000000000000000000000000000000000222222222222222222442222222222222222222222222
22222222222222222222222224422222222222222222220000000000000000000000000000000000022222222222222222222442222222222222222222222222
22222222222222222222222224422222222222222222222000000000000000000000000000000000022222222222222222222442222222222222222222222222
22222222222222222222222222222222222222222222220000000000000000000000000000000000002222222222222222222222222222222222222222222222
22222222222222222222222222222222222222222222200000000000000000000000000000000000000222222222222222222222222222222222222222222222
22222222222222222222222222222222222222222222200000000000000000000000000000000000000222222222222222222222222222222222222222222222
22222222222222222222222222222222222222222222200000000000000000000000000000000000002222222222222222222222222222222222222222222222
22222222222222222222222222422222222222222222222000000000000000000000000000000000002222222222222222222422222222222222222222222222
22222222222222222222222444422222222222222222222000000000000000000000000000000000022222222222222222222444422222222222222222222222
22222222222222222222222444422222222222222222220000000000020000000000000000000000002222222222222222222444422222222222222222222222
22222222222222222222222244442222222222222222000000000000222200022002200000000000000022222222222222224444222222222222222222222222
22222222222222222222222222444442222222222220000000000002222222222222222000000000000022222222222224444422222222222222222222222222
22222222222222222222222222224442222222222220000000000022222222222222222200000000000002222222222224442222222222222222222222222222
22222222222222222222222222222442222222222220000000000002222222222222222220000000000002222222222224422222222222222222222222222222
22222222222222222222222222222442222222222222200000000000222222222222222200000000000222222222222224422222222222222222222222222222
22222222222222222222222222222442222222222222220000000000222222222222220000000000002222222222222224422222222222222222222222222222
22222222222222222222222222224442222222222222222000000000022222222222200000000000222222222222222224442222222222222222222222222222
22222222222222222222222222444422222222222222222200000000002222222222200000000002222222222222222222444422222222222222222222222222
22222222222222222222222444442222222222222222222220000000000022222222000000000002222222222222222222224444422222222222222222222222
22222222222222222222222444222222222222222222222222200000000000222200000000000222222222222222222222222244422222222222222222222222
22222222222222222222222442222222222222222222222222220000000000020000000000002222222222222222222222222224422222222222222222222222
22222222222222222222224442232222222222222222222222222000000000000000000000222222222222222222222222222324442222222222222222222222
22222222222222222224444422222222222222222222222222222200000000000000000002222222222222222222222222222222444442222222222222222222
22222222222222222224442222222222222222222222222222222220000000000000000002222222222222222222222222222222224442222222222222222222
22222222222222222224422222222222222222222222222222222222000000000000000022222222222222222222222222222222222442222222222222222222
22222244442222222244422322222222222222222222222222222222200000000000000222222222222222222222222222222222222444222222224444222222
44444444444422224444222222222222222222222222222222222222220000000000000222222222222222222222222222222222232244442222444444444444
44444422224444444422222222222222222222222222222222222222200000000000000222222222222222222222222222222222222222444444442222444444
22222222222244442222222222222222222222222222222222222222220000000000000222222222222222222222222222222222222222224444222222222222
22222222222222222222222222222222222222222222222222222222200000000000000222222222222222222222222222222222222222222222222222222222
22222222222222222222222222222222222222222222222222222222201000000000000222222222222222222222222222222222222222222222222222222222
22222222222222222222222222222222222222222222222222222222000000000000000022222222222222222222222222222222222222222222222222222222
22222222222222222222222222222222222222222222222222222220000000000000000002222222222222222222222222222222222222222222222222222222
02222222222222222222222222222222222222222222222222222200000000000000000000222222222222222222222222222222222222222222222002220222
00000000002222222222222222222222222222222222222222220000000000222200000000002222222222222222222222222222222222222222220000000000
00000000000000002222222222222222222222222222222222000000000022222222000000000022222222222222222222222222222222220000000000000000
00000000000000000222222222222222222222222222222200000000002222222222220000000000222222222222222222222222222222200000000000000000
00000000000000000022222222222222222222222222220000000000222222222222222200000000002222222222222222222222222222000000000000000000
00000000000000000000002222222222222222222222000000000022222222222222222222000000000022222222222222222222220000000000000000000000
00000000000000000000000222222222222222222200000000002222222222222222222222220000000000222222222222222222200000000000000000000000
00000000000000000000110222222222222222220000000000222222222222222222222222222200000000002222222222222222221100000000000000000000
00000000000000000000110022222222222222000000000022222222222222222222222222222222000000000022222222222222001100000000000000000000
00000000000000000000000022222222222200000000002222222222222222222222222222222222220000000000222222222222000000000000000000000000
00000000000000000000000222222222220000000000222222222222222222222222222222222222222200000000002222222222200000000000000000000000
00000000000000000000000220000000000000000022222222222222222222222222222222222222222222000000000000000022220000000000000000000000
00000000000000000000022220000000000000002222222222222222222222222222222222222222222222220000000000000002220000000000000000000000
00000000000000000000222220000000000000222222222222222222222222222222222222222222222222222200000000000002222000000000000000000000
00000000000000000002222200000000000022222222222222222222222222000022222222222222222222222222000000000000222000000000000000000000
00000000000000000002220000000000000022222222222222222222222200000000222222222222222222222222000000000000022220000000000000000000
00000000000000020002222002000000000002222222222222222222220000000000002222222222222222222220000000000000222222000000000000000000
00000000000000222022222222200000000022222222222222222222000000000000000022222222222222222222000000000002222222200020000000000000
00000000000022222222222222201100000222222222222222222200000000000000000000222222222222222222200000000022222222220222000000000000
20002000000022222222222222220000000222222222222220000000000000000000000000000022222222222222220000022222332222222222220000000002
22222220022002222222222222222000000022222222222220000000000000000000000000000002222222222222000000022222332222222222220002200022
22222222222222222222222222222200000002222222222220000000000000000000000000000022222222222220000000222222222222222222200222222222
22222222222222222222222222220000000002222222222200000000000000000000000000000000222222222220000000002222222222222222222222222222
22222222222222222222222222200000000002222222222000000000000000000000000000000000022222222220000000000222222222222222222222222222
22222222222222222222222222200000000002222222222000000000000000000000000000000000022222222220000000000222222222222222222222222222
22222222222222222222222222200000000002222222222000000000000000000000000000000000022222222220000000000222222222222222222222222222
33222222232222222222222222200000000002222222222000000000000000000000000000000000022222222220000000000222222222222222222222222222
33222222222222222222222222200000000002222222222000000000000000000000000000000000022222222220000000000222222222232222222222222222
22222222222222222222222222200000000002222222222000000000000000000000000000000000022222222220000000000222222222222222222222222222
22222222222222222222222222200000000002222222222000000000000000000000000000000000022222222220000000000222222222222222222222222222
22222222222222222222222222200000000002222222222000000000000000000000000000000000022222222220000000000222222222222222222222222222
22222222222222222222222222200000000002222222222000000000000000000000000000000000022222222220000000000222222222222222222222222222
22222222222222222222222222200000000002222222222000000000000000000000000000000000022222222220000000000222222222222222222222222222
22222222222222222222223333220000000002222222222200000000000000000000000000000002222222222220000000022222222222222222220222222222
22222220222222222222223333222000000002222222222220000000000000000000000000000002222222222220000000022222222222222222200022202222
22222000000002222222222222222000000222222222222220022200000000000000000000222022222222222222000000022222222222222222000000000000
00000000000000222222222222220000000222222222222222222222000000000000000022222222222222222222200000002222222222200000000000000000
00000000000000000022222222000000002222222222222222222222220000000000002222222222222222222222200000000002222222200000000000000000
00000000000000000002220000000000000022222222222222222222222200000000222222222222222222222222000000001102222222200000000000000000
00000000000000000002222011000000000002222222222222222222222222000022222222222222222222222220000000000022220220000000000000000000
00000000000000001100022000000000000000222222222222222222222222222222222222222222222222222200000000000002200000000000000000000000
00000000000000000000022000000000000000002222222222222222222222222222222222222222222222220000000000000002220000000000000000000000
00000000000000000000022000000000000000000022222222222222222222222222222222222222222222000000000000000022200000000000000000000000
00000000000000000000022220000002220000000000222222222222222222222222222222222222222200000000002220000222200000000000000000000000
00000000000000000000022222200222222200000000002222222222222222222222222222222222220000000000222222000222000000000000000000000000
00000000000000000000002222222222222222000000000022222222222222222222222222222222000000000022222222222220110000000000000000000000
00000000000000000000000002222222222222220000000000222222222222222222222222222200000000002222222222222222110000000000000000000000
00000000000000000000000022222222222222222200000000002222222222222222222222220000000000222222222222222222000000000000000000000000
00000000000000000002000222222222222222222222000000000022222222222222222222000000000022222222222222222222200020000000000000000000
00000000000000000022202222222222222222222222220000000000222222222222222200000000002222222222222222222222220222000000000000000000
00000000000000002222222222222222222222222222222200000000002222222222220000000000222222222222222222222222222222220000000000000000
00000000000000002222222222222222222222222222222222000000000022222222000000000022222222222222222222222222222222220000000000000000
00000000000000000222222222222222222222222222222222220000000000222200000000002222222222222222222222222222222222200000000000000000
00000000000220022222222222222222222222222222222222222200000000000000000000222222222222222222222222222222222222220002200000000000
00200000022222222222222222222222222222222222222222222222000000000000000022222222222222222222222222222222222222222222222002200220
22222222222222222222222222222222222222222222222222222222000000000000000022222222222222222222222222222222222222222222222222222222
22222222222222222222222222222222222222222222222222222220000000000000000002222222222222222222222222222222222222222222222222222222
22222222222222222222222222222222222222222222222222222222000000000000000222222222222222222222222222222222222222222222222222222222
22222222222222222222222222222222222222222222222222222222200000000000000222222222222222222222222222222222222222222222222222222222
22222222222244442222222222222222222222222222222222222222200000000000000222222222222222222222222222222222222222224444222222222222
44444422224444444422222222222222222222222222222222222222200000000000000222222222222222222222222222222222222222444444442222444444
44444444444422224444422222222222222222222222222222222222200000000000002222222222222222222222222222222222222444442222444444444444
22222244442222222244422222222222222222222222222222222222200000000000000222222222222222222222222222222222222444222222224444222222
22222222222222222224422322222222222222222222222222222222000000000000000022222222222222222222222222222222232442222222222222222222
22222222222222222224442222222222222222222222222222222200000000000000000000222222222222222222222222222222224442222222222222222222
22222222222222222222444442222222222222222222222222222200000000000000000000022222222222222222222222222224444422222222222222222222
22222222222222222222224442222222222222222222222222222000000000000000000000022222222222222222222222222224442222222222222222222222
22222222222222222222222442232222222222222222222222220000000000022000000000002222222222222222222222222324422222222222222222222222
22222222222222222222222444222222222222222222222222000000000000222200000000000022222222222222222222222244422222222222222222222222
22222222222222222222222244442222222222222222222222000000000022222222000000000022222222222222222222224444222222222222222222222222
22222222222222222222222222444442222222222222222220000000000222222222200000000002222222222222222224444422222222222222222222222222
22222222222222222222222222224442222222222222222200000000002222222222200000000000222222222222222224442222222222222222222222222222
22222222222222222222222222222442222222222222220000000000022222222222220000000000002222222222222224422222222222222222222222222222
22222222222222222222222222222442222222222222000000000002222222222222222200000000000022222222222224422222222222222222222222222222
22222222222222222222222222222442222222222222000000000002222222222222222220000000000022222222222224422222222222222222222222222222
22222222222222222222222222224442222222222220000000000022222222222222222200000000000002222222222224442222222222222222222222222222
22222222222222222222222224444422222222222220000000000000222222222222022200000000000002222222222222444442222222222222222222222222
22222222222222222222222224442222222222222222200000000000002222022200000000000000000222222222222222224442222222222222222222222222
22222222222222222222222224422222222222222222220000000000000000000000000000000000002222222222222222222442222222222222222222222222
22222222222222222222222224422222222222222222222000000000000000000000000000000000022222222222222222222442222222222222222222222222
22222222222222222222222222222222222222222222220000000000000000000000000000000000002222222222222222222222222222222222222222222222
22222222222222222222222222222222222222222222220000000000000000000000000000000000002222222222222222222222222222222222222222222222
22222222222222222222222222222222222222222222220000000000000000000000000000000000000222222222222222222222222222222222222222222222
22222222222222222222222222222222222222222222222000000000000000000000000000000000000222222222222222222222222222222222222222222222
22222222222222222222222222422222222222222222222000000000000000000000000000000000002222222222222222222422222222222222222222222222
22222222222222222222222444422222222222222222222000000000000000000000000000000000022222222222222222222444422222222222222222222222
22222222222222222222222444222222222222222222220000000000000000000000000000000000022222222222222222222244422222222222222222222222
22222222222222222222222442222222222222222222220000000000000000000000000000000000022222222222222222222224422222222222222222222222
22222222222222222222222442222222222222222222200000000000000000000000000000000000002222222222222222222224422222222222222222222222
22222222222222222222222442222222222222222222000000000000110000000000001100000000002222222222222222222224422222222222222222222222
22222222222222222222222442222222222222222222000000000000110000000000001100000000000222222222222222222224422222222222222222222222
