00000000000000000000000000111111120000000000000000000000000000000000001111000000001111000000000000211111110000000000000000000000
00000000000000000000000011111112000000000000000000000000000000000000111111000000001111000000000000001111110000000000000000000000
00000002222000000000000011111100000000000000000002222000000000000000111100000000022220000000000000001111110000000000022220000000
00022002222000000000000011111100000000000000000002222000000000000000111100000000022220000000000000001111110000000000022220022000
00220000000000000000000011111100000000000000220000000000000000000000111100000000000000000000000000001111110000000000000000002200
02200000000000000000000011111100000000000000220000000000000000000000000000000000000000000000000000001111111100000000000000000000
02200000000000000000000011111100000000000000000000000000000000000000000000000000000000000220000000000011111100000000000000000220
00220000000000000000000011111100000000000000220000000000000000000000000000000000000000002200000000000011111100000000000000002200
00000000000000000000000011111100000000000002200000000000000000000000000000000000000000000220000000000011111100000000000000000220
02200000000000000000000011111100000000000000220000000000000000000000000000000000000000002200000000000011111100000000000000002200
00220000000000000000001111111200000000000002200000000000000000000000001111000000000000000000000000000011111100000000000000002200
00000000000000000000001111110000000000000000220000000000000000000000111111112000000000002200000000000011111100000000000000000000
00000000000000000000001111110000000000000000220000000000000000000000111111112000000000002200000000000011111100000000000000000000
00000000000000000000001111110000000000000000022000000000000000000000111111120000000000022000000000000011111100000000000000000000
00000000000000000000001111110000000000000000000000000000000000000011111112220000000000000000000000000011111100000000000000000000
00000000000000000000001111110000000000000000000000000000000000001111111222000000000000000000000000000011111100000000000000000000
00000000000000000000001111111100000000000000000000000000000000001111122200000000000022220000000000000011111100000000000000000000
00000000000000000000000021111111000000000000000000000000000000001111000000000000002211110000000000001111111200000000000000000000
00000000000000000000000000111111000000000000000000000000000000001111000000000000221111111100000000111111120000000000000000000000
00000000000000000000000011111111000000000000000000000000000000001111000000000000211111111111000000111111000000000000000000000000
00000000000000000000001111111111000000000000000000000000000000111111000000000000211111111111000000111111000000000000000000000000
00000000000000002222111111111111000000000000000000000000000000111111000000000000211111111111000000111111000000000000000000000000
00000000000000002222111111111111111111000000000000000000000000111100000000000000221111111111000000111111000000000000000000000000
00000000000000001111111221111111111111110000000000000000000000111100000000000000001111111111111111111111222200000000000000000000
00000011111111111111222222111111111111111100000000000000000000111100000000000000002111111111111111111111222200000000000000000000
00001111111111111111222222111111111111111111000011111111000011111100222222222222222221111111111111122111111100000000000000000000
00111111111111111111111111111221111111111111111111111111111111111100222222222222222222211111111111222222111111000000000000000000
11111112211221122111111111222222211221111111111111111111111111120000222222222222222222222111111111222222111111111111111111110000
11111200000000000011111112222222222222211111111112211221111111000022222222222222222222222221122111111111111111111111111111111100
11120000000000000011111122222222222222221111111200002222211111002222222222222222222222222222222222111111111111111111111111111111
12000000000000000011111122222222222222221111110002222000222112222222222222222222222222222222222222211111111111111221122112211111
00000000000000000011111122222222222222221111110022000000000000222222222222222222222222222222222222222111111111120000000000002111
00000000000000000011111111222222222222221111110022000000000000222222222222222222222222222222222222222211111111000000000000000021
00000000000000000000111111112222222222221111110000000000000000222222222222222222222222222222222222222211111111000000000000000000
00000000000000000000111111112222222222221111112222000000000000222222222222222222222222222222222222222211111111000000000000000000
00000000000000000000111111112222222222222111112222000000000000222222222222222222222222222222222222222211111111000000000000000000
00000000000000000011111111112222222222222221120000000000000000222222222222222222222222222222222222222211111111000000000000000000
00000000000000000011111111112222222222222222220000000000000000222222222222222222222222222222222222222211111111000000000000000000
00000000000000000011111111112222222222222222220000000000000000222222222222222222222222222222222222222211111111000000000000000000
00000000000000000011111111112222222222222222220000000000000000222222222222222222222222222222222222221111111111000000000000000000
00000000000000000011111111222222222222222222220000000000000000222222222222222222222222222222222222111111111112000000000000000000
00000000000000001111111111222222222222222222222200000000000022222222222222222222222222222222222222111111111200000000000000000000
00000000000000001111111111222222222222222222222222000000000022222222222222222222222222222222222222111111110000000000000000000000
00000000000000001111111111222222222222222222222222000000000022222222222222222222222222222222222222111111110000000000000000000000
00000022022220001111111111222222222222222222222222000000002222222222222222222222222222222222222222111111110000000000000000000000
00000220002200002111111111222222222222222222222222220000222222222222222222222222222222221111111111111111110000000000000000000000
00002200000000002221111111222222222222222222222222222222222222222222222222222222222222111111111111111111120000000000000000000000
00002200000000000022211200000022222222222222222222222222222222222222222222222222222222111111111111111112000000000000000000000000
00000000000000000000222200000022222222222222222222222222222222222222222222222222222222211221122111111100000000000000000000000000
00000000000000000000000000000002222222222222222222222222222222222222222222222222000000000022220021111111000000000000022220000000
11222200000000000000000000000000222222222222222222222222222222222222222222222222000000000022220022211111000000000000022220000000
11222200000000000000000000000000222222222222222222222222222222222222222222222222000000000000000002201111000000000000000000000000
00000000000000000000000000000000222222222222222222222222222222222222222222222222220000000000000000001111000000000000000000002200
00000000000000000000000000000000222222222222222222222222222222222222222222222222222200000000000002201111000000000000000000000220
00000000000000002222000000000000222222222222222222222222222222222222222222222222222200000000000000221111000000000000000000002200
00000000000000021111220000000000222222222222222222222222222222222222222222222222222200000000000000221111000000000000000000000220
11000000000000011111110000000022222222222222222222222222222200000000222222222222222200000000000002201111000000000000000000002200
11111111000000011111111100000022222222222222222222222222220000000000002222222222222200000000000002201111000000000000000000000220
11111111110000011111111111000022222222222222222222222222220000000000002222222222222222000000000000111111000000000000000000002200
00111111110000002112211111110022222222222222222222222222220000000000002222222222222222000000000011111111000000000000000000002200
00000000000000000000002111111100222222222222222222222222000000000000000022222222222222000000001111111100000000000000000000022000
00000000000000000000000021111100222222222222222222222222000000000000000022222222222222000000001111111100000000000000000000000000
00000000000000000000000000111100222222222222222222222222000000000000000022222222222222222222221112111100000000000000000000000000
00000000000000000000000000111100222222222222222222222200000000000000000000222222222222222222222200111100000000000000000000000000
00000000000000000000000000111100222222222222222222222200000000000000000000222222222222222222222200111100000000000000000000000000
00000000000000000000000000111100222222222222222222222222000000000000000022222222222222222222222200111100000000000000000000000000
00000000000000000000000000111111110000000022222222222222000000000000000022222222222222222222222200111100000000000000000000000000
00000000000000000000000000111111110000000022222222222222000000000000000022222222222222222222222200111111000000000000000000000000
00000000000000000000000000111111110000000022222222222222220000000000002222222222222222222222222222111111110000000000001111111100
00000002222000000000000011111112000000000022222222222222220000000000002222222222222222222222222222002111111111110000001111111111
00000002222000000000000011111200000000000000222222222222220000000000002222222222222222222222222222000021111111111000000011111111
00000000000000000000000011110220000000000000222222222222222200000000222222222222222222222222222222000000211111111000000000000011
00220000000000000000000011112200000000000000222222222222222222222222222222222222222222222222222200000000002111111000000000000000
00000000000000000000000011112200000000000000222222222222222222222222222222222222222222222222222200000000002221122000000000000000
00220000000000000000000011110220000000000000222222222222222222222222222222222222222222222222222200000000000022220000000000000000
02200000000000000000000011112200000000000000002222222222222222222222222222222222222222222222222200000000000000000000000000000000
00220000000000000000000011110000000000000000000022222222222222222222222222222222222222222222222200000000000000000000000000000000
02200000000000000000000011110220000000000000000022222222222222222222222222222222222222222222222200000000000000000000000000000000
00220000000000000000000011111122002222000000000022222222222222222222222222222222222222222222222222000000000000000000000000222211
00220000000000000000000011111111002222000000000022222222222222222222222222222222222222222222222222000000000000000000000000222211
00022220000000000000000000111111111111111122222222222222222222222222222222222222222222222222222222000000222200000000000000000000
00000000000000000000000011111111111111111122222222222222222222222222222222222222222222222222222222000022111122000000000000000000
00000000000000000000001111111111111111111122222222222222222222222222222200002222222222222222222222222211111111220000000000220000
00000000000000000000001111111112211221122222222222222222222222222222220000000022222222222222222222222211111111110000000000220000
00000000000000000000001111111122222222222222222222222222222222222222000000000022222222222222222222222211111111110000220002200000
00000000000000000000001111111122222222222222222222222222222222222222000000000022222222222222222222222211111111110002222022000000
00000000000000000000001111111122222222222222222222222222222222222222000000000000222222222222222222222211111111110000000000000000
00000000000000000000111111111122222222222222222222222222222222222200000000000000002222222222222222222211111111120000000000000000
00000000000000000011111111111122222222222222222222222222222222222200000000000000002222222222222222222211111111000000000000000000
00000000000000000011111111122222222222222222222222222222222222222200000000000000002222222222222222221111111111000000000000000000
00000000000000000011111111222222222222222222222222222222222222222200000000000000002222222222222222221111111111000000000000000000
00000000000000000011111111222222222222222222222222222222222222222200000000000000002222222222222222221111111111000000000000000000
00000000000000000011111111222222222222222222222222222222222222222200000000000000001111222222222222221111111112000000000000000000
00000000000000000011111111222222222222222222222222222222222222222200000000000022221111112222222222221111111100000000000000000000
00000000000000000011111111222222222222222222222222222222222222222200000000000022221111112222222222221111111100000000000000000000
00000000000000000011111111222222222222222222222222222222222222222200000000000000001111112222222222222111111100000000000000000000
11000000000000000011111111222222222222222222222222222222222222222200000000000002201111112222222222222221111111000000000000000000
11110000000000001111111111112222222222222222222222222222222222222200000000000022001111112222222222222222111111000000000000000000
11111111111111111111111111111122222222222222222222222222222222222211112200022220001111112222222222222222111111000000000000000011
21111111111111111111111111111122222222222222222222222222222222220011111122220000111111112222222222222222111111000000000000001111
00211111111111111111111112211111111111222222222222222222222222000011111111111111111111111122222222222211111111000000000000111111
00002112211221122111111122222211111111112222222222222222222200001111111111111111111111111111111122222211111111111111111111111112
00000000000000000021111122222211111111111122222222222222222200111111122111111111122111111111111111111121122111111111111111111200
00000000000000000000211111111111111111111111222222222222222200111112000021122112000021111111111111111122222211111111111111120000
00000000000000000000222211111111111111111111110000000000000000111100000000000000000000211111111111111122222211111221122112000000
00000000000000000000222211111112211211111111110000000000000000111100000000000000000000002111111111111111111111120000000000000000
00000000000000000000222211111100000011111111110000000000000000111100000000000000000000000021122111111111111122220000000000000000
00000000000000000000000011111100000011111111111200000000000011111100000000000000000000000000000011111111111122220000000000000000
00000000000000000000000011111100000011111111111200000000000011111100000000000000000000000000000011111111122222220000000000000000
00000000000000000000000011111100000021111111111200000000000011110000000000000000000000000000000011111112000000000000000000000000
00000000000000000000001111111200000000211111122200000000000011110000000000000000000000000000000011111100000000000000000000000000
00000000000000000000111111120000000000002112220000000000000011110000000000000000000000000000000021111111000000000000000000000000
00000000000000000000111111000000000000002222000000000000221111110000000000000000000000000000000000211111110000000000000000000000
00000000000000000000111111000000000000000000000000000022111111120000000000000000000000000000000000001111110000000000000000000000
00000000000000000000111111000000000000000000000000002211111112000000000000000222200000000000000000001111110000000000000000000000
00000000000000000000111111000000000000220000000000001111111100000000000000000222200000000000000000001111110000000000000000000000
00000000000000000000111111000000000000000000000000021111111100000000000000000000000000000000000000001111110000000000000000000000
00220000000000000000111111000000000000220000000000022111111200000000000000000000000022000000000000001111110000000000000000002200
02200000000000000000111111000000000002200000000000000021100000000000000000000000000002200000000000111111110000000000000000002200
00220000000000000000111111000000000000220000000000000000000000000000000000000000000022000000000000111111000000000000000000000220
00000000000000000000111111000000000002200000000000000000000000000000000000000000000022000000000000111111000000000000000000002200
00220000000000000000111111000000000002200000000000000000000000000000000000000000000002200000000000111111000000000000000000000220
02200000000000000000111111000000000000220000000000000000000000000000000000000000000022000000000000111111000000000000000000000000
00220000000000000000111111110000000000000000000000000000111100000000000000000000000002200000000000111111000000000000000000002200
00022002222000000000001111110000000000000002222000000000111100000000000000000000000022000000000000111111000000000000022220022000
00000002222000000000001111110000000000000002222000000000111100000000000000000000000220000000000000111111000000000000022220000000
11111000000000000000001111110000000000000011110000000011111100000000000000000000000000000000000000111111000000000000000000011111
11111111111111111111111111111111111111111111111111111111111111111111111111111111111111111111111111111111111111111111111111111111
