00000000000000000000000000002222000000000000000000000000000000000000000000000000000000000000000000002222200000000000000000000000
00000000000000000000000002222200000000000000000000000000000000000000000000000000000000000000000000000222200000000000000000000000
00000000000000000000000002222000000000000000000000000000000000000000000000000000000000000000000000000222200000000000000000000000
00000000000000000000000002222000000000000000000000000000000000000000000000000000000000000000000000000222200000000000000000000000
00000000000000000000000002222000000000000000000000000000000000000000000000000000000000000000000000000222200000000000000000000000
00000000000000000000000002222000000000000000000000000000000000000000000000000000000000000000000000000022222000000000000000000000
00000000000000000000000002222000000000000000000000000000000000000000000000000000000000000000000000000002222000000000000000000000
00000000000000000000000002222000000000000000000000000000000000000000000000000000000000000000000000000002222000000000000000000000
00000000000000000000000002222000000000000000000000000000000000000000000000000000000000000000000000000002222000000000000000000000
00000000000000000000000002222000000000000000000000000000000000000000000000000000000000000000000000000002222000000000000000000000
00000000000000000000000222220000000000000000000000000000000000000000000000000000000000000000000000000002222000000000000000000000
00000000000000000000000222200000000000000000000000000000000000000000022222200000000000000000000000000002222000000000000000000000
00000000000000000000000222200000000000000000000000000000000000000000022222200000000000000000000000000002222000000000000000000000
00000000000000000000000222200000000000000000000000000000000000000000022222000000000000000000000000000002222000000000000000000000
00000000000000000000000222200000000000000000000000000000000000000000222200000000000000000000000000000002222000000000000000000000
00000000000000000000000222200000000000000000000000000000000000000222220000000000000000000000000000000002222000000000000000000000
00000000000000000000000022220000000000000000000000000000000000000222000000000000000000000000000000000002222000000000000000000000
00000000000000000000000000222220000000000000000000000000000000000220000000000000000000000000000000000022220000000000000000000000
00000000000000000000000000022220000000000000000000000000000000000220000000000000000022220000000000022222000000000000000000000000
00000000000000000000000000222220000000000000000000000000000000000220000000000000022222222220000000022220000000000000000000000000
00000000000000000000000022222220000000000000000000000000000000022220000000000000022222222220000000022220000000000000000000000000
00000000000000000000022222222220000000000000000000000000000000022200000000000000002222222220000000022220000000000000000000000000
00000000000000000000022222222222000000000000000000000000000000022000000000000000000222222220000000022220000000000000000000000000
00000000000000000020000000222222222222000000000000000000000000022000000000000000000222222220000000222220000000000000000000000000
00000000000000002220000000022222222222220000000000000000000000022000000000000000000022222222222222222220000000000000000000000000
00000022222222222220000000022222222222222200000000000000000000222000000000000000000000222222222222000000020000000000000000000000
00002222222222222222000020000000222222222222000022222222000022220000000000000000000000002222222220000000022200000000000000000000
00222200000000000022222220000000000000222222222222222222222222000000000000000000000000000022222220000000022222000000000000000000
22220000000000000002222200000000000000002222222200000000222220000000000000000000000000000000000000020000222222222222222222220000
22000000000000000002222000000000000000000222220000000000002220000000000000000000000000000000000000022222222222222222222222222200
00000000000000000002222000000000000000000222200000000000000000000000000000000000000000000000000000002222222222220000000000002222
00000000000000000002222000000000000000000222200000000000000000000000000000000000000000000000000000000022222222000000000000000022
00000000000000000000222200000000000000000222200000000000000000000000000000000000000000000000000000000002222220000000000000000000
00000000000000000000022222200000000000000222200000000000000000000000000000000000000000000000000000000002222220000000000000000000
00000000000000000000022222200000000000000222200000000000000000000000000000000000000000000000000000000002222220000000000000000000
00000000000000000000022222200000000000000022200000000000000000000000000000000000000000000000000000000002222220000000000000000000
00000000000000000002222222200000000000000000000000000000000000000000000000000000000000000000000000000002222220000000000000000000
00000000000000000002222222200000000000000000000000000000000000000000000000000000000000000000000000000002222220000000000000000000
00000000000000000002222222200000000000000000000000000000000000000000000000000000000000000000000000000002222220000000000000000000
00000000000000000002222222000000000000000000000000000000000000000000000000000000000000000000000000000022222220000000000000000000
00000000000000000002222220000000000000000000000000000000000000000000000000000000000000000000000000022222222200000000000000000000
00000000000000000222222220000000000000000000000000000000000000000000000000000000000000000000000000022222220000000000000000000000
00000000000000000222222220000000000000000000000000000000000000000000000000000000000000000000000000022222200000000000000000000000
00000000000000000222222220000000000000000000000000000000000000000000000000000000000000000000000000022222200000000000000000000000
00000000000000000222222220000000000000000000000000000000000000000000000000000000000000000000000000022222200000000000000000000000
00000000000000000022222220000000000000000000000000000000000000000000000000000000000000000000000000222222200000000000000000000000
00000000000000000000222200000000000000000000000000000000000000000000000000000000000000022222222222222222000000000000000000000000
00000000000000000000000000000000000000000000000000000000000000000000000000000000000000022222222222222200000000000000000000000000
00000000000000000000000000000000000000000000000000000000000000000000000000000000000000000000000022222000000000000000000000000000
00000000000000000000000000000000000000000000000000000000000000000000000000000000000000000000000000222220000000000000000000000000
00000000000000000000000000000000000000000000000000000000000000000000000000000000000000000000000000002220000000000000000000000000
00000000000000000000000000000000000000000000000000000000000000000000000000000000000000000000000000000220000000000000000000000000
00000000000000000000000000000000000000000000000000000000000000000000000000000000000000000000000000000220000000000000000000000000
00000000000000000000000000000000000000000000000000000000000000000000000000000000000000000000000000000220000000000000000000000000
00000000000000000000000000000000000000000000000000000000000000000000000000000000000000000000000000000220000000000000000000000000
00000000000000000000000000000000000000000000000000000000000000000000000000000000000000000000000000000220000000000000000000000000
00000000000000022222000000000000000000000000000000000000000000000000000000000000000000000000000000000220000000000000000000000000
00000000000000022222220000000000000000000000000000000000000000000000000000000000000000000000000000000220000000000000000000000000
00000000000000002222222200000000000000000000000000000000000000000000000000000000000000000000000000002220000000000000000000000000
00000000000000000000002222000000000000000000000000000000000000000000000000000000000000000000000000222200000000000000000000000000
00000000000000000000000022222000000000000000000000000000000000000000000000000000000000000000000222222000000000000000000000000000
00000000000000000000000000222000000000000000000000000000000000000000000000000000000000000000000222222000000000000000000000000000
00000000000000000000000000022000000000000000000000000000000000000000000000000000000000000000000000022000000000000000000000000000
00000000000000000000000000022000000000000000000000000000000000000000000000000000000000000000000000022000000000000000000000000000
00000000000000000000000000022000000000000000000000000000000000000000000000000000000000000000000000022000000000000000000000000000
00000000000000000000000000022000000000000000000000000000000000000000000000000000000000000000000000022000000000000000000000000000
00000000000000000000000000022000200000000000000000000000000000000000000000000000000000000000000000022000000000000000000000000000
00000000000000000000000000022222200000000000000000000000000000000000000000000000000000000000000000022200000000000000000000000000
00000000000000000000000000022222000000000000000000000000000000000000000000000000000000000000000000002222000000000000000000000000
00000000000000000000000002222200000000000000000000000000000000000000000000000000000000000000000000000022220000000000000000000000
00000000000000000000000002220000000000000000000000000000000000000000000000000000000000000000000000000000222222222000000000000000
00000000000000000000000002200000000000000000000000000000000000000000000000000000000000000000000000000000002222222000000000000000
00000000000000000000000002200000000000000000000000000000000000000000000000000000000000000000000000000000000022220000000000000000
00000000000000000000000002200000000000000000000000000000000000000000000000000000000000000000000000000000000000000000000000000000
00000000000000000000000002200000000000000000000000000000000000000000000000000000000000000000000000000000000000000000000000000000
00000000000000000000000002200000000000000000000000000000000000000000000000000000000000000000000000000000000000000000000000000000
00000000000000000000000002200000000000000000000000000000000000000000000000000000000000000000000000000000000000000000000000000000
00000000000000000000000002200000000000000000000000000000000000000000000000000000000000000000000000000000000000000000000000000000
00000000000000000000000002220000000000000000000000000000000000000000000000000000000000000000000000000000000000000000000000000000
00000000000000000000000000222200000000000000000000000000000000000000000000000000000000000000000000000000000000000000000000000000
00000000000000000000000000022222000000002000000000000000000000000000000000000000000000000000000000000000000000000000000000000000
00000000000000000000000000222222222222222000000000000000000000000000000000000000000000000000000000000000000000000000000000000000
00000000000000000000000222222222222222220000000000000000000000000000000000000000000000000000000000000002222200000000000000000000
00000000000000000000000222222200000000000000000000000000000000000000000000000000000000000000000000000002222222200000000000000000
00000000000000000000000222222000000000000000000000000000000000000000000000000000000000000000000000000002222222200000000000000000
00000000000000000000000222222000000000000000000000000000000000000000000000000000000000000000000000000002222222200000000000000000
00000000000000000000000222222000000000000000000000000000000000000000000000000000000000000000000000000002222222200000000000000000
00000000000000000000002222222000000000000000000000000000000000000000000000000000000000000000000000000002222222000000000000000000
00000000000000000002222222220000000000000000000000000000000000000000000000000000000000000000000000000002222220000000000000000000
00000000000000000002222222000000000000000000000000000000000000000000000000000000000000000000000000000222222220000000000000000000
00000000000000000002222220000000000000000000000000000000000000000000000000000000000000000000000000000222222220000000000000000000
00000000000000000002222220000000000000000000000000000000000000000000000000000000000000000000000000000222222220000000000000000000
00000000000000000002222220000000000000000000000000000000000000000000000000000000000200000000000000000222222200000000000000000000
00000000000000000002222220000000000000000000000000000000000000000000000000000000000222200000000000000222222000000000000000000000
00000000000000000002222220000000000000000000000000000000000000000000000000000000000222200000000000000222222000000000000000000000
00000000000000000002222220000000000000000000000000000000000000000000000000000000000222200000000000000022222000000000000000000000
00000000000000000002222220000000000000000000000000000000000000000000000000000000000222200000000000000000222220000000000000000000
22000000000000000022222222000000000000000000000000000000000000000000000000000000000222200000000000000000022220000000000000000000
22220000000000002222222222222000000000000000000000000000000000000002000000000000000222200000000000000000022220000000000000000000
00222222222222222222222222222000000000000000000000000000000000000002220000000000002222200000000000000000022220000000000000000022
00002222222222222222222200000002000000000000000000000000000000000002222200000000222222220000000000000002222220000000000000002222
00000000000000000022222000000002222222000000000000000000000000000022222222222222222222222200000000000002222222000000000000222200
00000000000000000000222000000002222222220000000000000000000000022222000022222222000022222222222200002000000022222222222222220000
00000000000000000000000002000022222222222200000000000000000000022200000000000000000000222222222222222000000002222222222222000000
00000000000000000000000002222222222222222222200000000000000000022000000000000000000000002222222222222000000002220000000000000000
00000000000000000000000002222200000002222222200000000000000000022000000000000000000000000022222222222200002000000000000000000000
00000000000000000000000002222000000002222222200000000000000000022000000000000000000000000000000022222222222000000000000000000000
00000000000000000000000002222000000002222222222000000000000002222000000000000000000000000000000002222222220000000000000000000000
00000000000000000000000002222000000002222222222000000000000002220000000000000000000000000000000002222222000000000000000000000000
00000000000000000000000002222000000000222222220000000000000002200000000000000000000000000000000002222200000000000000000000000000
00000000000000000000000022220000000000002222000000000000000002200000000000000000000000000000000002222000000000000000000000000000
00000000000000000000022222000000000000000000000000000000000002200000000000000000000000000000000000222200000000000000000000000000
00000000000000000000022220000000000000000000000000000000000022200000000000000000000000000000000000002222200000000000000000000000
00000000000000000000022220000000000000000000000000000000002222000000000000000000000000000000000000000222200000000000000000000000
00000000000000000000022220000000000000000000000000000000222200000000000000000000000000000000000000000222200000000000000000000000
00000000000000000000022220000000000000000000000000000222222000000000000000000000000000000000000000000222200000000000000000000000
00000000000000000000022220000000000000000000000000000222222000000000000000000000000000000000000000000222200000000000000000000000
00000000000000000000022220000000000000000000000000000022220000000000000000000000000000000000000000000222200000000000000000000000
00000000000000000000022220000000000000000000000000000000000000000000000000000000000000000000000000022222000000000000000000000000
00000000000000000000022220000000000000000000000000000000000000000000000000000000000000000000000000022220000000000000000000000000
00000000000000000000022220000000000000000000000000000000000000000000000000000000000000000000000000022220000000000000000000000000
00000000000000000000022220000000000000000000000000000000000000000000000000000000000000000000000000022220000000000000000000000000
00000000000000000000022220000000000000000000000000000000000000000000000000000000000000000000000000022220000000000000000000000000
00000000000000000000002222200000000000000000000000000000000000000000000000000000000000000000000000022220000000000000000000000000
00000000000000000000000222200000000000000000000000000000000000000000000000000000000000000000000000022220000000000000000000000000
00000000000000000000000222200000000000000000000000000000000000000000000000000000000000000000000000022220000000000000000000000000
00000000000000000000000222200000000000000000000000000000000000000000000000000000000000000000000000022220000000000000000000000000
00000000000000000000000222200000000000000000000000000000000000000000000000000000000000000000000000222200000000000000000000000000
