00000000222200000011111111110000000000000022222200000000000000000000000000000000000000000000000000000000000000000000000000000000
00000000222200000000111111110000000000002200022022000000000000000000000000000000000000000000000000000000000000000000000000000000
00022000000000000000001111000000000000000000000000000000000000000000000000000000000000000000000000000000000000000000000000000000
00220000000000000000000000000000000000000000000000000000000000000000000000000000000000000000000000000000000000000000000220000000
00022000000000000000000000000000000000000000000000000000000000000000000000000000000000000000000000000000000000000000111100000000
00220000000000000000000000000000000000000000000000000000000000000000000000000000000000000000000000000000000000000011111111000000
00000000000000000000000011110000000000000000000000000000000000000000000000000000000000001111000000000000000000000011111111000000
00220000000000000000001111111100000000000000000000000000000000000000000000000000000000111111110000000000000000002222111111000000
00022000000000000000001111111100000000000000000000000000000011111200111111110000000000111111111100000000000000002222111111110000
00022000000000000000001111111100000000000000000000000011111111111111111111111100000000111111111111000000000000000011111111110000
00000000000000000000111111111111000000000000000000000111111111111111111111111100000011111111111111110000000000001111111111000000
00000000000000000000111111111111110000000000000000011111111111211111001111111112000011111000111111111100000000001111111111000000
00000000000000000000111111111111111100000000000000011112000000000000001111111112222111110000001111111102200220221111111111110000
11000000000000111111111111111111111100000000000000021112220000000000000000001122222111110000001111111100222222111111111111110000
11001111000011111111111111111111110000000000000000022222220000000000000000002222222211000000001111111111111111111111111111000000
11111111111111111111111111111111111111000000000022222222222000000000000000002222222222000000000011111111111111111111111111000000
11111111111111111111111111111111111111111111111122222222222000000000000000002222222222000000000000111111111111111111111111110000
11111111111111111111111111111111111111111111111122222222222200000000000000002222222222000000000000111111111111111111111111110000
11111111111111111111111111111111111111111111111222222222222200000000000000002222222222000000000000001111111111111111111111000000
11111111111111111111111111111111111111111111112222222222222220000000000000002222222222000000000000001111111111111111111111000000
11111111111111111111121111111111111111111111002222222222222220000000000000002222222222000000000000000011111111111111111111110000
11111111111111111111111111111111111111110000002222222222222222000000000000002222222222000000000000000011111111111111111111110000
11111111111111111111111111111111121100000000000222222222222222000000000000002222222222000000000000000000001111111111111111110000
11111111111111001111000022111111111100000000000222222222222222200000000000002222222222000000000000000000000000222200111111111100
11000000110000000000000011111111111100000000000022222222222222200000000000002222222222000000000000000000000000222200000000111100
00000000000000000000000000001111111100000000000022222222222222220000000000002222222222000000000000000000000000000000002221110000
00000000000000000000000000001111111100000000000002222222222222220000000000002222222222000000000000000000000000000000000221110000
00000000000000000000000000001111111200000000000002222222222222222000000000002222222222000000000000000000000000000000002211110000
00000000000000000000000000001111111100000000000000222222222222222000000000002111222222000000000000000000000000000000000221110000
00000000000000000000000000001111111100000000000000222222222222222200000000002111111112000000000000000000000000000000002211110000
00000000000000000000000000000011111111000000000000022222222222222110001112211111111112000000000000000000000000000000000221110000
00000000000000000000000000000011111111000000000000022222222222221110111111111111111111000000000000002111000000000000002211110000
00000002222000000000000000001111111112000000000000002222222222221111111111111111111111000000000000001111120000000000000011110000
00022002222000000000000000001100111111000000000000002222222222222111111111111111111100000000000000001111110000000000002111111100
00220000000000000000000000000021111111000000000000000222222222000000001111111111111100000000000000001111110000000000222111111100
00000000000000000000000000000011111112000000000000000022212200000000001111111111111100000000000000001111000000000001112211110000
02200000000000000000000000000011111112220000000000000022111100000000001111111111110000000000000000001111000000000000111222000000
00220000000000000000000000000011111122222200000000000022111110000000000011111111000000000000000000001111000000000000111222000000
02200000000000000000000000000011112222222222000000000000011110000000000000001111120000000000000000001111111111000021110000000000
02200000000000000000000000002111002222222222220000000000211122220000000000111111110000000000000000001111111111120011110000000000
00220000000000000000000000001111002222222222222200000000111122220000000000111111110000000000000000000011111111110011111111111200
02200000000000000000000000001111111222222222222222000000111100000000000000001111000110000000000000001111111111110000111111111111
00220000000000000000000000001111111222222222222222220011112200000000000000000011120110000000000000211111110000000000001111111111
00000000000000000000000000001111112222222222222222111111022000000000000000000011111100000000000000111111000000000000000000221111
00000000000000000000000000211111222222222222222221111111220000000000000000000011111200000000000000111111120000000000000000000000
00000000000000000000000000111111222222222222222221111111022000000000000000000002111222000000000000111111110000000000000000000000
00000000000000000000000000111100222222222222222222111100220000000000000000000002222222220000000000111111110000000000000000000000
00000000000000000000000021111100002222222222222222200000000000000000000000000022222222222200000000001111000000000000000000000000
00000000000000000000000011111100000022222222222222200000000000000000000000000022222222222222000000211111000000000000000000000000
00000000000000000000000011111100000000222222222222000000000000000000002200111112222222222222220000111111000000000000000000000000
00000000000000000000002111111100000000002222222122000000000000000000022011111112222222222222222200111100000000000000000000000000
00000000000000000000001111111100000000000022221111000000000000000000002211111122222222222222222222111100000000000000022220000000
00000000000000000000001111111200000000000000221111100000000000000000022011112222222222222222222211111100000000000000022220022000
11110000000000000000000011111100000000000000000111100000000000000000221111112222222222222222222111111100000000000000000000002200
11111111110000000000001111111100000000000000000011110000000000000000111111002222222222222222222111111100000000000000000000000000
00001111111100002111111111110000000000000000000011111100000000002222111111000022222222222222220011111100000000000000000000000220
00000000001112001111111111000000000000000000002111111100000000002222011100000000222222222222220011111100000000000000000000002200
00000022211111001111111111120000000000000000001111110000000000000001111100000000002222222222111111110000000000000000000000000220
00000022211111000011111111110000000000000000001111111111000000000001111200000000000022222221111111000000000000000000000000000220
00000011221100000000000011110000000000000000000011111111110000000002111222000000000000222211111100000000000000000000000000002200
00001111122200000000000011110000000000000000001111111111110000000002222222000000000000002211111100000000000000000000000000000220
00111111112200000000000011110000000000000000211111111111110000000222222222200000000000000011111100000000000000000000000000002200
00111111112200000000002111110000000000000000111111111111111111112222222222200000000000000021111100000000000000000000000000000000
00001112000000000000001111110000000000000000111111111111111111112222222222220000000000000011111100000000000000000000000000000000
00001111220000000000001111110000000000001111111111111121111111122222222222220000000000000011111100000000000000000000000000000000
00001111220000000000000011110000000000002111111111111111111100222222222222222000000000000011111100000000000000000000000000000000
00001112200000000000000000000000000000001111121111111111111100222222222222222000000000000011111112000000000000000000000000000000
00001111220000000000000000000000000000001111122221111111111100222222222222222200000000000000111111110000000000000000000000000000
00001112200000000000000000000000000000000011222221111111000000022222222222222200000000000000111111110000000000000000000000000000
00001111220000000000000000000000000000000022222222110000000000022222222222222220000000000000111111120000000000000000000000000000
00001111220000000000000000000000000000000022222222220000000000002222222222222220000000000000111111110000000000000000000000000000
00111111000000000000000000000000000000000022222222220000000000002222222222222222000000000000111111110000000000000000000000000000
00111100000000222200000000000000000000000022222222220000000000000222222222222222000000000000111111111100000000000000000000011011
00001112211100222200000000000000000000000022222222220000000000000022222222222222200000000022111111111100011000000012011001111111
00001111111111111111110000000000000000000022222222220000000000000022222222222222200000000011111111111111111000111111111111111111
00001111111111111111111200000000000000000022222222220000000000000022222222222222220000001111111111111111111111111111111111111111
00000011111111111111111100000000000000000022222222220000000000000002222222222222211011211111111111111111111111111111111111111111
00000011111111111111111111120000000000000022222222220000000000000002222222222222111011111111111111111111111111111111111111111111
00001111111111111111111111110000000000000022222222220000000000000000222222222222111111111111111111111111111111111111111111111111
00001111111111111111111111111100000000000022222222220000000000000000222222222222211111111111111111111111111111111111111111111111
00000011111111111111111111111100000000000022222222220000000000000000022222222200000000000011111111111111111111111111111111111111
00000011111111111111111111111111000000000022222222220000000000000000002221220000000000000000001111111111111111111111000011110011
00001111111111111122222200111111120000000022222222220000000000000000002211110000000000000000111111111111111111111100000000000011
00001111111111112202200220111111110000000021222222220000000000000000002211111000000000000000111111111111111100000000000000000000
00000011111111110000000000111111111100000021100001120000000000001111001111111000000000000000001111111111111100000000000000000000
00000011111111110000000000001111111100001111000001121111000011111111111111110000000000000000000011111111111100000000000000022000
00001111111111000000000000000011110000111100000000111111111111111111110000000000000000000000000000111111110000000000000000002200
00001111111122220000000000000000111111110000000000000000111100001111000000000000000000000000000000111111110000000000000000002200
00000011111122220000000000000000001111000000000000000000000000000000000000000000000000000000000000111111110000000000000000022000
00000011111111000000000000000000000000000000000000000000000000000000000000000000000000000000000000001111000000000000000000002200
00000011111111000000000000000000000000000000000000000000000000000000000000000000000000000000000000000000000000000000000000000000
00000022111100000000000000000000000000000000000000000000000000000000000000000000000000000000000000000000000000000000000000002200
00000000000000000000000000000000000000000000000000000000000000000000000000000000000000000000000000000000000000000000000000022000
00000000000000000000000000000000000000000000000000000000000000000000000000000022022000220000000000000011110000000000222200000000
11111000000000000000000000000000000000000000000000000000000000000000000000000000222222000000000000001111111100000000222200011111
11111111111111111111111111111111111111111111111111111111111111111111111111111111111111111111111111111111111111111111111111111111
