22222222222222222222200222222222222222222222222222222222222222222222222222222222222222222222222222222222222222222222222222222222
22222222222222222222222022222222222222222222222222222222222222222222222222222222222222222222222222222222222222222222222222222222
22222222222222222222222222222222222222222222222222222222222222222222222222222222222222222222222222222222222222222222222222222222
22222222222222222222222222222222222222222222222222222222222222222222222222222222222222222222222222222222222222222222222222222222
22222222222222222222222222222222222222222222222222222222222222222222222222222222222222222222222222222222222222222222222222222222
22222222222222222222222222222222222222222222222222222222222222222222222222222222222222222222222222222222222222222222222222222222
22222222222222222222222222222222222222222222222222222222222222222222222222222222222222222222222222222222222222222222222222222222
22222222222222222222222222222222222222222222222222222222222222222222222222222222222222222222222222222222222222222222222222222222
22222222222222222222222222222222222222222222222222222222222222222222222222222222222222222222222222222222222222222222222222222222
22222222222222222222222220022222222222222222222222222222222222222222222222222222222222222000222222222222222222222222222222222222
22222222222222222222222222222222222222222222222222222222222222222222202222222222222222222200002222222222222222222222220222222222
22222222222222222222222200202222222222222222222222222220222000002222000000022222222222200000000222222222222222222222002222222222
22222222222222222222222222222222222222222222222222222200000000000000000000022222222222200000002222222222222222222220022222222222
22222222222222222222222222222220222222222222222222222222000000000000000000002222222222220000000222222222222222222222022202222222
22222222222222222222222222022202222222222222222222222222200000000000000000000222222222000000002222222222222222222222000222222222
22222222222222222222222222222222222222222222222222222222200000000000000000000222222220000000000022222222222222222222222222222222
22222222222222222222222222222222222222222222222222222222220000000000000000000222222220000000000000000222222222222022222222222222
22222222222222222222022222202222022022222222222222222222220000000000000000000222222220000000000000000222222222222200222222222222
22222222222222222222222222022222000222222222202222222222222000000000000000000222222220000000000000000222222220222222222222222222
02202222222222220222222222222222222222222000000222222222222000000000000000000222222220000000000000002220222200202222222222222222
22222000222222222022202222222202222222222200000022222222222200000000000000000222222220000000000000000000022222222222222222222222
22222222222222222222200222222222222202220000000022222222222200000000000000000222222220000000000000000000222222222222220022222222
22222222200000222222200222222222200000000000000002222222222220000000000000000222222220000000000000000000002222222222222002222222
22220222000000002220000000002222200000000000000002222222222220000000000000000222222220000000000000000000000000000000222222222222
22000000000000000000000011000222200000000000000000222222222222000000000000000222222220000000000000000000000000000000000000222222
00000000000000000000000000000222200000000000000000222222222222000000000000000222222220000000000000000000000000000000000000222222
00000000000000000000000000000222220000000000000000022222222222200000000000000222222220000000000000000000000000000000000002222222
00000000000000000000000000002222220000000000000000022222222222200000000000000222222220000000000000000000000000000000000022222222
00000000000000000000000000000022222000000000000000002222222222220000000000000222222220000000000000000000000000000000000002222222
00000000000000000000000000000002222200000000000000002222222222220000000000000222222220000000000000000000000000000000000002222222
00000000000000000000000000000022222000000000000000000222222222222200000200002222222220000000000000000000000000000000000002222222
00000000000000000000000000000002222200000000000000000222222222222220022220022222222220000000000000000020000000000000000022222222
00000000000000000000000000000022222220000000000000000022222222222202222220022222222222000000000000000222000000000000000002222222
00000000000000000000000000000000222220000000000000000022222222222222222200222222222200000000000000000222200000000000000202222222
00000000000000000000000000000000222222000000000000000002222222222222222222222222222000000000000000000222200000000000002220222222
00000000000000000000000000000002222000000000000000000002222222222222222222222222222200000000000000002222000000000000222222222222
00000000000000000000000000000002220222000000000000000000222222222222222222022222200000000000000000000220000000000000222222222222
00000000000000000000000000000002222222220000000000000000000222222222222222222222000000000000000000002222000000000000022222222222
00000000000000000000000000000002222222222200000000000000000222222222222222222222000000000000000000000222200200000000222222222222
00000000000000000000000000000222222222222222000000000000002222222222222222222222200000000000000000000222222222000002222222222222
00000000000000000000000000000222222222222222220000000000022222222222222222222222220000000000000000000022222222200022222222222222
00000000000000000000000000000222222222222222222200000000222222222222222222222220000000000000000000000222222022220000222222222222
00000000000000000000000000000222222222222222222222000002222222222222222222222222000000000000000000002222220000000000000222202222
00000000000000000000000000000222222222222222222222220022222222222222222222222222200000000000000000022222000000000000000000002222
00000000000000000000000000002220022222222222222222220222222222222222222222222222220000000000000000022222000000000000000000000000
00000000000000000000000000022220002222222222222222202222222222222222222222222222222200000000000000002222200000000000000000000000
00000000000000000000000000022200000022222222222222222222222222222222222222222222222222000000000000000222200000000000000000000000
00000000000000000000000000222000000000222222222222222222222222222222222222222222222222220000000000000222000000000000000000000000
00000000000000000000000002222200000000002222222222222222222222222222222222222222222222222200000000002220000000000000000000000000
00000000000000000000000022220000000000000022222222222222222222222222222222222222222222222222000000022220000000000000000000000000
00000000000000000000000222200000000000000000222222222222222222222222222222222222222222222222220000022200000000000000000000000000
00000000000000000000000222200000000000000000002222222222222222222222222222222222222222222222222200022000000000000000000000000000
00000000000000000000002222222000000000000000000002222222222222222222222222200222222222222222222222222200000000000000000000000000
02000000000000000000000022222000000000000000000002222222222222222222222222200022222222222222222222022000000000000000000000000000
22220000200000000000000222222000000000000000000002222222222222222222222222000000222222222222222220222000000000000000000000000000
22222222222000000020002222200000000000000000000002222222222222222222222200000000002222222222222222222000000000000000000000000000
22222222222200000222222222000000000000000000000000222222222222222222222000000000000022222222222222222200000000000000000000000000
22222222222220002222222222000000000000000000000222222222222222222222222200000000000000222222222222220000000000000000000000000000
22222222222222000002222222200000000000000000000222222222222222222222220000000000000000002222222222000000000000000000000000000000
22222222222200000000000022200000000000000000000022222222222222222222222200000000000000000022222200000000000000000000000000000000
22222222222000000000000002200000000000000000000222222222222222222222222220000000000000000000022000000000000000000000000000000000
22222222220000000000000022220000000000000000022222220022222222222222222220000000000000000000022200000000000000000000000000000000
22222200000000000000000022200000000000000000022222222222222222222222222222000000000000000002222000000000000000000000000000000000
22222220000000000000000222220000000000000000022222222220222222222222222222000000000000000002222000000000000000000000000000000000
22222220000000000000000222200000000000000002222222222200222220222222222222200000000000000022222000000000000000000000000000000000
22222222000000000000000022200000000000000022222222222002222200022222222222200000000000000000222200000000000000000000000000000000
22222220000000000000000000000000000000000222222222222222220000002222222222220000000000000000022200000000000000000000000000000000
22222222000000000000000000000000000000000222222222222000000000002222222222220000000000000000022220000000000000000000000000000000
22222220000000000000000000000000000000000022222222222200000000000222222222222000000000000000022220000000000000000000000000000000
22222220000000000000000000000000000000000002222222220000000000000222222222222000000000000000222222000000000000000000000000000000
22222220000000000000000000000000000000000002222222200000000000000022222222222200000000000000002222200000000000000000000000000000
22222222000000000000000000000000000000000002222222200000000000000022222222222200000000000000000222220000000000000000000000000000
22222200000000000000000000000000000000000002222222200000000000000002222222222220000000000000002222200000000000000000000000000002
22222200002000000000000000000000000000000002222222200000000000000002222222222220000000000000000222200000000000000000000002000222
22222220022200022000200000000000000000000002222222200000000000000000222222222222000000000011002222220000200000022000200222222222
22222222222222222222220000000000000000000002222222200000000000000000222222222222000000000220022222222222222002222222222222222222
22222222202222222222222000000000000000000002222222200000000000000000022222222222220000002222222222222222222222222222222222222222
22222222222222222222222202000000000000000002222222200000000000000000022222222222222000022222222222222222222222222222222202200222
22222222222222222000222222200000000000000002222222200000000000000000002222222222220220022222222222222222222222022222222222220002
22222222222222222222222222200000000000000002222222200000000000000000002222222222222222222222020022220222222222222222022222222222
22222222222220222222222222200000000000000002222222200000000000000000000222222222222222222222222222222222222222222222222222222222
22222222222222202222222222200020000000000002222222200000000000000000000222222222222222222222222222222222222222222222222222222222
22222222222222222222222222222222000000000002222222200000000000000000000022222222222222222222222222222222220222222222222222222222
22222220000022222222222222222222200000000002222222200000000000000000000000022222222222222222222202222222222222222222222222222222
22222222222002222222222222222222200000000002222222200000000000000000000020022222222222222222222222222222222222222222222222222222
22222222222222222222222222222222200000000222222222200220000000000000022222222222222222222222222222222222222222222222222222222222
22222222220022222222222222222222220000022222222222222222200222222002222222222222222222222222222222222000222222222222222222222222
22222222022222222222222222222222222002222222222222222222222222222222222222222222222222222222222222222002222222222222222222222222
22222222222222222222222222222222222222222222222222222222222222222222222222222222222222222222222222222222222222222222222222222222
22222222222222222222222222222222222222222222222222222222222222222222222222222222222222222222222222222222222222222222222222222222
22222222222222222222222222222222222222222222222222222222222222222222222222222222222222222222222222222222222222222222222222222222
22222222222222222222222222222222222222222222222222222222222222222222222222222222222222222222222222222222222222222222222222222222
22222222222222222222222222222222222222222222222222222222222222222222222222222222222222222222222222222222222222222222222222222222
22222222222222222222222222222222222222222222222222222222222222222222222222222222222222222222222222222222222222222222222222222222
22222222222222222222222222222222222222222222222222222222222222222222222222222222222222222222222222222222222222222222222222222222
22222222222222222222222222222222222222222222222222222222222222222222222222222222222222222222222222222222222222222222222222222222
