1111111111111111111111111111111111111111111111111111111111111111111111111111111111111111111111111111111111111111111111111111111111111111
1111111111111111111111111111110011111111111111111111111111111111111111111111111111111111111111111111111111111111111111111111111111111111
1111111111111111111111111111000000000011111111111111111111111111111111111111111111111111111111111111111111111111111111111111111111111111
1111111111111111111111111100000000000001111111111111111111111111111111111111000000001111111111111111111111111111111111111111111111111111
1111111111111111111111110000000000000000111111111111111111111111111111110000222000000001111111111111111111110011111100001111111111111111
1111111111111111111111100000000000000000011111111111111111111111111111100000222002200000111111111111111111100001111000000111111111111111
1111111111111111111111000000000000000000000111111111111111111111111111100000222022022000011111111111111100000000000000000000001111111111
1111111111111111111110000000000000000000000211111111111111111111111111000000000000000220011111111111111000000000000000000000000111111111
1111111111111111111100000000000000000000002221111111111111111111111110000000000000000022011111111111110000000000000000000000000011111111
1111111111111111111100000000000000000000022222111001111111111100001100000000000000000000011111111111100000000000002220000000000001111111
1111111111111111111200000000000000000000222222220000001111111000000000000000000000000022011111111111000000000000002220022000000001111111
1111111111111111111220200000002000000002222222220000000111111000000000000000000000000002201111111110000000000000002220220220000001111111
1111111111111111111022220000002220000022222222200000000111110000000000000000000000000022001111111110000000000000000000000000220000111111
1111111111111111110002020000000022001112222222000000002111100000000000000000000000000000001111111110000000000000000000000000022000011111
1111111000000000000000000000000002201111222220000000002222000000000000000000000000000022201111111100000000000000000000000000000000011111
1111100000000000000000000000001111111111122200000000002222000000000000000000000000000022211111111000000000000000000000000000022000011111
1111000022000000000000000000001111001111122000000000002222000000000000000000000000000022211111111000000000000000000000000000002200011111
1110002202200000000000000001111110000111100000000000002222000000000000000000000000000000011111111000000000000000000000000000022000011111
1110022000000000000000000011110000000011110000000000002222000000000000000000000000000000011111111000000000000000000000000000000000001111
1100220000000000000000000111100000000011110000000000002222000000000000000000000000000000011111111100000000000000000000000000022200000111
1000000000000000000000001111000000002221100000000000002222000000000000000000000000000000001111111110000000000000000000000000022200000111
1000220000000000000000001110000022002220000000000000002222000000000000111100000000000000001111111110000000000000000000000000022200001111
1102200000000000000000001100002202202220000000000000002111110000000000111110000000000000001111111110000000000000000000000000000000011111
1100220000000000000000001000022000000000000000000000000111111000000000011110000000000000011111111111000000000000000000000000000000011111
1100000000000000000000001000220000000000000000000000000111111100000000001100000000000001111111111111100000000000000000000000000000001111
1102220000000000000000011000000000000000000000000000001111111110000000000000000000000011111111111111100000000000000000000000000000000111
1112220000000000000011110000220000000000000000000000011111111110000000000000000000000011111111111111100000000000000000000000000000000111
1112220000000000000011100002200000000000000000000000011111111110000000000000000000000011111111111111100000000000000000000000000000001111
1110000000000000000111100000220000000000000000000000011111111111000000000000000000000001111110111111100000000000000000000000000000011111
1111002220000000000111110000000000000000000000000000011111111111100000000000000000000000111000000111110000000000000000000000000000011111
1111102220000000000111111002220000000000000000000000011111111111100000000000000000000000000222000001111110000000000000000000000000011111
1111102220000000000111111002220000000000000000000000011111111111100000000000000000000000000222002200011111000000000000000000000000111111
1111100000000000000111111002220000000000000000000000000000111111100000000000000011100000000222022022000111100000000001111110000001111111
1111111000000000000211111000000000000000000000000000000000011111112000000000000111110000000000000000220011100000000221110011000011111111
1111111100000000002221111000000000000000000000000000000000111111122200000000000111100000000000000000022001100000002221110001111111111111
1111111110000000022222111000000000000000000000000000000000111111222220000000000011000000000000000000000011110000002222110000000001111111
1111111111000000222222220000000000000000000000000000000000011022222222000000000000000000000000000000022011111000011122210000000000111111
1111111111100002222222220000000000000000000000000000000000000022222222200000000000000000000000000000002211111100111112220000000000011111
1111111111110022222222200000000000000000011111100000000000000002222211110000000000000000000000000000022001111111111111200002220000001111
1111111111111112222222000000000000011000111111100000000000000000222111111000000000000000000000000000000011111110000000000002220000000111
1111111111111111222220000000000000111111111111100000000000000000022111111200000000000000000000000000022211111100000000000002220000000111
1111111111111111122200000000000000111111111111110000000000000000002111111111100000000000000000000000022211111000000000000000000000000111
1111111100001111122000000000000000011111111111111000000000000000000111111111111100000000000000000000022201111000000000000000000222000011
1111111000000111100000000000000000022111111111111220000000000000000011111111111110000000000000000000000011111000000000000000000222000001
1111000000000011110000000000000000222111111111111222000000000000000002211111111110000000000000000000000011111000000000000000000222000001
1110000000000011110000000000000002222211111111112222200000000000000000011111111110000000000000000000000211111100000000000000000000000001
1110000002220001100000000000000022222221111111122222220000000000000000001111111110000000000000000000002221111110000000000000000220000001
1110000002220000000000000000000222222222000000222222220000000000000000000111111110000000000000000000022222111110000000000000000022000001
1100000002220000000000000000002222222220000000022222111000000000000000000011111100000001110000000000222222220000000000000000000220000001
1000002200000000000000000000022222222200000000002221111100000000000000000001111100000001110000000002222222220000000000000000000000000011
1000022000000000000000000000222222222000000000000211111110000000000000000000111100000001110000000021111222200000000000000000000220000111
1000000000000000000000000000222222220000000000000011111111000000000000000000011100000000000000011111111222000000000000000000002200000111
1000022000000000000000000111112222200000000000000011111111100000000000000000011100000000000000011111111220000000000000000022022000000111
1000220000000000000000000111111222000000000000000011111111122000000000000000111000000000000000001111111200000000000000000002200000001111
1000000000000000000000000111111120000000000000000001111111122200000000000001111000000000000000001111122000000000000000000000000000011111
1000220000000000000000000111111100000000000000000001111111222220000000000011111000000000000000001111100000000000000001100000000000011111
1000022000000000000000000111111100000000000000000000111112221111000000000111111100000000000000001111100000000000000011110000000000011111
1000000000000000000000000111111110000000000000000000011122211111100001101111111100000000000000001111100000000000000011110000000000111111
1000022000000000000000000011111111000000000000000000000002211111120011111111111100000000000000001111000000000000000111100000000001111111
1100002200000000000000000001111111200000000000000000000000211111120011111111111000000000000000001110000000000000000111110000000011111111
1110000002220000000000000001111112220000000000000000000000011111111111111111112200000000000000001110000000000000000111111111111111111111
1110000002220000000000000001111122222000000000000000000000001111111101111111100222000000000000011110000000000000000111111111111111111111
1110000002220000000000000000002222222200000000000000000000000211111011000000000002200000000000111111000000000000000011111111111111111111
1111000000000000000000000000002222222220000000000000000000000000000001100000000000000000000001111111000000000000000001111111111111111111
1111111000000000000000000000000222222222000000000000000000000000000011000000000000000000000011111110000000000000000001111111111111111111
1111111100000000000000000000000022222221111000000000000000000000000110000000000000000000000011111112200000000000000001111111111111111111
1111111111111110000000000000000002222211111100000000000000000000000222000000000000000000000011111112220000000000000000001111111111111111
1111111111111111000000000000000000222111111100000000000000000000002220000000000000000000000011111122222000000000000000000111111111111111
1111111111111111111000000000000000022111111100000000000000000000000110000000000000000000000001111222222200000000000000000000000011111111
1111111111111111111000000000000000000111111100000000000000000000001100000000000000000000000000002222222220000000000000000000000001111111
1111111111111111111000000000000000001111111000000000000000000000011000000000000000000000000000000222222222000000000000000000000000001111
1111111111111111111100000000000000001111110000000000022000000000001101111120000000000000000000000022222222000000000000000000222000000111
1111111111111111111110000000000000000111100000000000002220011111111011111111000000000000000000000002222211111000000000000000222000000111
1111111111111111111110000000000000000111000000000000000022111111111111111111100000000000000000000000222111111000000000000000222000000111
1111111100000000111110000000000000000111000000000000000001111111111100211111120000000000000000000000021111111000000000000000000022000011
1111111000000000011110000000000000001111000000000000000011111111111100211111122000000000000000000000001111111100000000000000000002200001
1111110000000000111100000000000000011111000000000000000011111111011000011111122211100000000000000000000111111110000000000000000000000001
1111100000000000111100000000000000011111000000000000000011111110000000001111222111110000000000000000000011111110000000000000000002200001
1111100000000000011000000000000000011111000000000000000001111100000000000222221111111000000000000000000011111110000000000000000000220001
1111100000000000000000000000000002211111000000000000000001111000000000000022211111111000000000000000000211111110000000000000000000000001
1111000000022000000000000000000021111111000000000000000001110000000000000002211111111100000000000000002221111110000000000000000000220001
1110000002202200000000000000000221111111100000000000000011100000000000000000011111111100000000000000022222111110000000000000000002200001
1110000022000000000000000000002221111111100000000000000011100000000000000000001111111100000000000000222222220000000000000000000000000001
1110000220000000000000000000022221111200000000111000000011110000000000000000000111111120000000000002222222220000000000000000000002200001
1100000000000000000000000000222222222000000000111000000011111000000000000000000011111222000000000022222222200000000000000000000022000001
1000000220000000000000000000222222220000000000111000000011111100000000000000000001112222200000000222222222000000000000000000222000000011
1000002200000000000000000111112222200000000000000000000111111110000000000000000000222222220000002222222220000000000000000000222000000111
1000000220000000000000000111111222000000000000000000000111111111000000000000000000222222211111111222222200000000000000011000222000000111
1000000000000000000000000011111120000000000000000000000111111111100000000000000000022222111111111122222000000000000000111100000000000111
1000002220000000000000000001111100000000000000000000000111111111122000000000000000002221111111111112220000000000000000111100000000001111
1000002220000000000000000001111100000000000000000000000111111111111100000000000000000221111111111112200000000000000000011110000001111111
1100002220000000000000000001111022200000000000000000000011111111111110000000000000000001111111111111100000000000000002211111000011111111
1110000000000000000000000001111122200000000000000000000000011111111112000000000000000000111111111111110000000000000022211111111111111111
1110000000222000000000000011111122200000000000000000000000000021111112200000000000000000011111111111110000000000000222221111111111111111
1110000000222000000000000111111100000000000000000000000000000001111112220000000000000000011111110001100000000000002222222111111111111111
1111000000222000021111111111111002200000000000000000000000000000111122222000000000000000011111100000000000000000022222222200111111111111
1111100000000000222111110011111122000000000000000000000000000000022222222200000000000000000000000000000000000000222222222000011111111111
1111110000000000122211100001111102200000000000000000000000000000002222222201100000000000000000000000000000000000222222220000001111111111
1111111000000000112222000000111100000000000000000000001100000000000222221111110000000000000000000000000000000001112222200000000111111111
1111111111111000111222000000011002200000000000000000011110000000000022211111110000000000000000000000000000000001111222000000000011111111
1111111100001100111220000000011100220000000000000000111110000000000002111111100000000000000000000000000000000001111120000000000001111111
1111111000000111111000000000011110002202202220000000011100000000000000011111110000000000000000000000000000222001111110000000000000011111
1111110000000000000000000000001111100022002220000000000000000000000000011111111111100000000000000000000000222001111110000000000222011111
1111100000000000000000000000000111111000002220000000000000000000000000011111111111100000000000000000000000222001111110000000000222011111
1111100000000000000000000000000000111110000001110000000000000000000000011111111111100000000000000000000000000000111110000000000222001111
1111100000000000000000000000000000011111110111111000000000000000000000001111111111100000000000000000000000220000011110000000000000000111
1111000000000000000000000000000000011111111111111100000000000000000000000111111111100000000000000000000000022000011100000000000000222111
1110000000000000000000000000000000011111111111111100000000000000000000000111111111100000000000000000000000220000111100000000000000222111
1110000000000000000000000000000000011111111111111100000000000000000000000111111111000000000000000000000000000001100000000000000000222011
1111000000000000000000000000000000011111111111111000000000000011000000000011111110000000000000000000000000220001000000000000000000000011
1111100000000000000000000000000000001111111111100000000000000111100000000001111110000000000000000000000002200001000000000000000000220011
1111100000000000000000000000000000000111111111000000000000000111110000000000111112000000000000000222022022000011000000000000000000022011
1111000022200000000000000000000000000111111111000000000000000011110000000000002222000000000000000222002200000111000000000000000000220001
1110000022200000000000000000000000000111111111000000000000000000000000000000002222000000000000011222000000001111000000000000000000000001
1110000022200000000000000000000000000011111111100000000000000000000000000000002222000000000000111100000000011110000000000000000000220011
1111000000000000000000000000000000000001111111100000000000000000000000000000002222000000000000111100000000111100000000000000000002200111
1111100002200000000000000000000000000001111111100000000000000000000000000000002222000000000000011110000111111000000000000000022022000111
1111100022000000000000000000000000000001111111122200000000000000000000000000002222000000000002211111001111000000000000000000002200001111
1111100002200000000000000000000000000001111111122200000000000000000000000000002222000000000022211111111111000000000000000000000000011111
1111100000000000000000000000000000000011111111022200000000000000000000000000002222000000000222221111022000000000000000000000000001111111
1111100002200000000000000000000000000111111111000000000000000000000000000000011112000000002222222111002200000000202000111111111111111111
1111110000220000000000000000000000000111111111002200000000000000000000000000111110000000022222222200000222000000222201111111111111111111
1111111000000220220222000000000000000111111111022000000000000000000000000001111110000000222222222000000002000000020221111111111111111111
1111111000000002200222000000000000001111111111102200000000000000000000000001111111000000222222220000000000000000000021111111111111111111
1111111000000000000222000000000000011111111111100000000000000000000011000011111111111001112222200000000000000000000011111111111111111111
1111111100000000000000000000000000111111111111102200000000000000000111111111111111111111111222000000000000000000000011111111111111111111
1111111110000000000000000000000001111111111111100220000000000000001111111111111111111111111120000000000000000000000111111111111111111111
1111111111000000000000000000000011111111111111100002202202220000011111111111111111111111111110000000000000000000001111111111111111111111
1111111111111110000001111000011111111111111111110000022002220000011111111111111111111111111111100000000000000000011111111111111111111111
1111111111111111000011111100111111111111111111111000000002220000111111111111111111111111111111110000000000000000111111111111111111111111
1111111111111111111111111111111111111111111111111111000000001111111111111111111111111111111111111000000000000011111111111111111111111111
1111111111111111111111111111111111111111111111111111111111111111111111111111111111111111111111111100000000001111111111111111111111111111
1111111111111111111111111111111111111111111111111111111111111111111111111111111111111111111111111111111100111111111111111111111111111111
1111111111111111111111111111111111111111111111111111111111111111111111111111111111111111111111111111111111111111111111111111111111111111
