1111111111111111111111111111111111111111111111111111111111111111111111111111111111111111111111111111111111111111111111111111111111111111
1111111111111111111111111111111111111100000000001111111111111111111111110000001111111111111111111111111100001111111111111111111111111111
1111111111111111111111111111111111111000000000000111111111111111111111100000000111111111111111111111111000000111111111111111111111111111
1111111111110011111100001111111111000000000000000000111111111111111100000000000000111111111111111100000000000000001111111111111111111111
1111111111100001111000000111111110000000000022200000011111111111111000000000000000011111111111111000000000022200000111111111111111111111
1111111100000000000000000000111100000000220022200000001111111111110000000000000000001111111111111000000220022200000111111111111111111111
1111111000000000000000000000011100000022022022200000000111111111100000002202200000000111111111111000022022022200001111111111111111111111
1111111000000000000000000000011100022000000000000000000111111111000000022000220000000111111111000022000000000000001111111111111111111111
1111111000000000000222000000011100220000000000022200000111111111000022000000000220000111111110000220000000000022201111111111111111111111
1111000000000002200222000000001110000000000000022200000011111111000220000000000022000011111110000000000000000022200111111111111111111111
1110000000000220220222000000000100220000000000022200000001111111000000000000000000000001111110000220000000000022200111111111111111111111
1110000000220000000000000000000102200000000000000000000001111110002220000000000022200001111110002200000000000000000111111111111111111111
1110000002200000000000000000001100220000000000000000000001111110002220000000000022200001111111100220000000000000000011111111111111111111
1110000000000000000000000000011110000000000000000000000001111110002220000000000022200001111111110000000000000000000011111111111111111111
1110000002200000000000000000011111000000000000000000000001111110000000000000000000000001111111110000000000000000000011111111111111111111
1110000022000000000000000000001111000000000000000000000001111110000000000000000000000001111111110000000000000000000011111111111111111111
1110000002200000000000000000000111112000000000000000000011111100000000000000000000000011111111110000000000000000000011111111111111111111
1110000000000000000000000000000111122200000000000000000111111100000000000000000000000111111111110000000000000000000011111111111111111111
1111000022200000000000000000000111222100000000000000001111111100000000000000000000000111111111100000000000000000000011111111111111111111
1111100022200000000000000000000022221100000000000001111111111110000000000000000000001111111111100000000000000000000011111111111111111111
1111100022200000000000000000000022211100000000000221111111111112200000000000000000001111111111112000000000000000000011111111111111111111
1111100000000000000000000000000002211100000000002221111111111112220000000000000000001111111111122200000000000000000001111111111111111111
1111100000000000000000000000000000011100000000022222111111111122222000000000000000001111110111222220000000000000000001111111111111111111
1111000000000000000000000000000000001100000000222222210000001222222200000000000000000111100022222222000000000000000001111111111111111111
1110000000000000000000000000000000000100000000222222220000002222222220000000000000000000000022222222200000000000000001111111111111111111
1110000000000000000000000000000000000100000001112222200000000222222222000000000000000000000002222222220000000000000000111111111111111111
1111000000000000000000000000000000001100000011111222000000000022222222000000000000000000000000222222210000000220000001111111111111111111
1111100000000000000000000000000000011111111111111120000000000002222211100000000000000000000000022222111000002220000001111111111111111111
1111110000000000000000000000000000111111111111111000000000000000222111111110000000000000000000002221111110222000000001111111111111111111
1111111000000000000000000000011111111111111111111000000000000000021111111111000000000000000000000221111111200000000000111111111111111111
1111111000000000000000000000111111111111111111111000000000000000001111111111000000000000000000000001111111100000020022111111111111111111
1111111000000000000000011111111111111111111111110000000000000000001111111111100000000000000000000000111111110000022221111111111111111111
1111111100000000000000011100110000122211111111100000000000000000001111111111110000000000000000000000011111110000002001111111111111111111
1111111111100000000000011111100220022211111111100000000000000000001111111111110000000000000000000000011111100000000001111111111111111111
1111111111110000000000111000022022022201111111100000000000000000021111111111100000000000000000000000111111222000000001111111111111111111
1111111111111000000111100022000000000000111111100000000000000000211111111111000000000000000000000001111110002220000001111111111111111111
1111111111111100001100000220000000000022211111000000000000000002111111100000000000000000000000000011111110000220000001111111111111111111
1111111111111111111100000000000000000022200110000000000000000021111112000000000000000000000000000111111100000000000011111111111111111111
1111111111111111111100000220000000000022200000000000000000000211111112000000000000000011110000001111111000000000000111111111111111111111
1111111111111111111110002200000000000000000000000000000000002111111120000000000000000111111001111111110000000000001111111111111111111111
1111111111111111111110000220000000000000000000000000000000021111111200000000000000001111111011111111100000000000011111111111111111111111
1111111111111111111100000000000000000000000000000000000000211111112000000000000000001111111111111111000000000000111111111111111111111111
1111111111111111111000000000000000000000000000000000000000111111120000000000000000001111111111111110000000000000111111111111111111111111
1111111111111111111000000000000000000000000000000000000011111111200000000000000000001111111111110000000000000001111111111111111111111111
1111111111111111111100000000000000000000000000000000000111111112000000000000000000001111111111100000000000000211111111111111111111111111
1111111111111111111100000000000000000000000000000000000111111220000000000000000000011111111111000000000000002221111111111111111111111111
1111111111111111111110000000000000000000000000000000001111111000000000000000000002211111111111000000000000022222111111111111111111111111
1111111111111111111111000000000000000000110000000000001111110000000000000000000022211111111111000000000000222222220011111100111111111111
1111111111111111111111100000000000000001111000000000011111100000000000000000000222221111111111000000000002222222220011111100011111111111
1111111100000011111111100000000000000111111102000000011111100000000000000000002222222111111110000000000022222222200001111000001111111111
1111111000000001111111112000000000001111111122220111111111122000000000000000022222222200111122000000000012222222000000000000000111111111
1111110000000000001111122200000000001111111122221110101111122200000000000000222222222000000002220000000111222220000000000000000000111111
1111100000000000001111222220000000001111111100201000000111222220000000000002222222220000000000020000001111122200000000000000000000011111
1111000000222000000022222222000000001111111100000000000012222222000000000022222222200000000000000000011111122000000000000000000000001111
1110000000222000000022222222200000001111111100000000000022222222200000000022222222000000000000000000011111100000000000000002220000000111
1110000000222000000002222222220000000111111100000000000002222222220000000111222220000000000000000000011111000000000000000002220000000111
1110000220000000000000222222210000000011111100000000000000222222220000001111122200000000000000000000011111111000000000000002220000000111
1100002200000000000000022222110000000000000000000000000000022222111000011111112000000000000000000000011111111100000000000000000220000011
1000000000000000000000002221111110000000000000000000000000002221111100111111100000000000000000000000011111111100000000000000000022000001
1000002200000000000000000221111111000000000000000000000000000211111111111111100000000000000000000000011111111100000000000000000000000001
1000022000000000000000000001111111100000000000000000000000000011111111111111000000000000000000000000111111111100000000000000000022000001
1000000000000000000000000001111111110000000000000000000000000011111111111110000000000000000000000000111111111000000000000000000002200001
1000022000000000000000000001111111110000000000000000000000000111111111111100000000000000000000000000111111111000000000000000000000000001
1000002200000000000000000011111111110000000000000000000000001111111111111100000000000000000000000000011111111000000000000000000002200001
1000000000000000000000000011111111100000000000000000000000011111111111111120000000000000000000000000001111111220000000000000000022000001
1000002200000000000000000011111111100000000000000000000000011111110011111222000000000000000000000000000111111222000000000000000000000001
1100000220000000000000000011111111100000000000000000000002111111100001112222200000000000000000000000000000112222200000000000000022000011
1110000000222000000000000001111111100000000000000000000022211111000000222222220000000000000011111100000000122222220000000000000220000111
1110000000222000000000000000001111100000000000000000000222221110000000222222222000000000000011111110000000222222222000000002220000000111
1110000000222000000000000000011111100000000000000000002222222200000000022222222200000000000011111111000000022222222200000002220000000111
1111000000000000000000000002211111100000000000000000022222222200000000002222222100000000000011111111000000002222222200000002220000001111
1111100000000000000000000022211111000000200000000000222222222000000000000222221110000001020011111111000000000222221111000000000000011111
1111110000000000000000000222221110000000222000000002222222220000000000000022211111010111222211111111000000000022211111000000000000111111
1111111110000000000000002222222100000000002211110022222222200000000000000002211111111110222211111111000000000002111111111000000001111111
1111111111000001111000022222222200000000000111111112222222000000000000000000011111100000002011111110000000000000011111111100000011111111
1111111111100011111100222222222000000000001111111111222220000000000000000000011111100000000001111000000000000000011111111111111111111111
1111111111110011111100222222220000000000001111111111122200000000000000000000111111000000000000110000000000000000001111111111111111111111
1111111111111111111111112222200000000000001111111111122000000000000000000001111111000000000000000000000000000000000111111111111111111111
1111111111111111111111111222000000000000001111111111100000000000000000000221111110000000000000000000000000000000000011111111111111111111
1111111111111111111111111120000000000000011111111111000000000000000000002111111110000000000000000000000000000000000011111111111111111111
1111111111111111111111111000000000000000111111111111000000000000000000021111111100000000000000000000000000000000000001111111111111111111
1111111111111111111111110000000000000111111111111111000000000000000000211111110000000000000000000000000000000000000001111111111111111111
1111111111111111111111110000000000001111111111111111000000000000000002111111120000000000000000000000000000000000000011111111111111111111
1111111111111111111111100000000000011111111101111111000000000000000021111111200000000000000000000000000000000220000111111111111111111111
1111111111111111111111000000000000111111111001111110000000000000000211111112000000000000000000000000000000000022000111111111111111111111
1111111111111111111110000000000001111111000000111100000000000000002111111120000000000000000000022200000000000220000011111111111111111111
1111111111111111111100000000000011111110000000000000000000000000002111111200000000000000000110022200000000000000000011111111111111111111
1111111111111111111000000220000111111100000000000000000000000000011111112000000000000000001111122200000000000220000011000011111111111111
1111111111111111111000000222000111111000000000000000000000001111111111120000000000000000011111110000000000002200011110000001111111111111
1111111111111111111000000002221111110000000000000000000000011111111111200000000000000000011111111022202202200001110000000000111111111111
1111111111111111111000000000011111100000000000000000000000111111111111000000000000000000011111111122200220011111100000000000011111111111
1111111111111111111002000000111111100000000000000000000000111111111111000000000000000000011111111122210000110011100000000000000011111111
1111111111111111111222200000111111110000000000000000000000011111111111000000000000000000111111111111111111111111100000000000000001111111
1111111111111111112200200000011111111000000000000000000000001111111111000000000000000001111111111111111111110000000000000000000001111111
1111111111111111110000000000021111111220000000000000000000001111111111200000000000000001111111111111111111100000000000000000000001111111
1111111111111111111000000002220111111222000000000000000000000111111112220000000000000001111111111111110000000000000000000000000000111111
1111111111111111111000000222000001112222200000000000000000000000011122222000000000000211111111111111100000000000000000000000000000011111
1111111111111111111000000220000000122222220000000000000000000000002222222200000000002221111100000011000000000000000000000000000000001111
1111111111111111110000000000000000222222222000000000000000000000002222222220000000022222111000000010000000000000000000000000000000000111
1111111111111111111000000000000000022222222200000000000000000000000222222222000000222222220000000010000000000000000000000000000000000111
1111111111111111111000000000000000002222222200011110000000000000000022222221000000122222220000000011000000000000000000000000000000001111
1111111111111111111000000000000000000222221110111111000000000000000002222211111111112222200000000011100000000000000000000000000000011111
1111111111111111111000000000000000000022211111111111000000000000000000222111111111111222000000000011122000000000000000000000000000011111
1111111111111111111100000000000000000002111111111111000000000000000000022111111111111220000000000011122200000000000000000000022200011111
1111111111111111111100000000000000000000011111111111000000000000000000000111111111111000000000000011222200000000000000000000022200011111
1111111111111111111100000000000000000000011111111110000000000000000000000011111111000000000000000012221110000000000000000000022200001111
1111111111111111111100000000000000000000111111111110000000000000000000000011111110000000000000000022211110000000000000000000000000000111
1111111111111111111100000000000000000000111111111100000000000000000000000011111100000000000000000002111110000000000000000000022000000111
1111111111111111111100000000000000000000111111111000000000000000000000000111111000000000000000000000001111000000000000000000002200000111
1111111111111111111100000000000000000000111111111000000000000000000000000111111000000000000000000000001111100000000000000000022000000111
1111111111111111111100000000000000000000111111111000022200000000000222000111111000000000000000000000000111100000000000000000000000000111
1111111111111111111100000000000000000220011111111000022200000000000222000111111000000000000000000000220011000000000000000000022000000111
1111111111111111111110000000000000000022000111111000022200000000000222000111111000000000000000000000022010000000000000000000220000000111
1111111111111111111110022200000000000220000111111000000000000000000000001111111000000022200000000000220010000000002220220220000000000111
1111111111111111111110022200000000000000000111111100002200000000000220001111111100000022200000000000000111000000002220022000000000001111
1111111111111111111111022200000000000220000111111110000220000000002200001111111110000022200000000000220011100000002220000000000001111111
1111111111111111111111000000000000002200001111111110000000220002200000001111111110000000000000000002200011100000000000000000000001111111
1111111111111111111111000022202202200001111111111110000000022022000000011111111110000000022202202200000011100000000000000000000001111111
1111111111111111111110000022200220000001111111111111000000000000000000111111111111000000022200220000000011110000000000000000000011111111
1111111111111111111110000022200000000001111111111111100000000000000001111111111111100000022200000000000111111110000001111000011111111111
1111111111111111111111000000000000000011111111111111110000000000000011111111111111110000000000000000001111111111000011111100111111111111
1111111111111111111111111110000001111111111111111111111110000000011111111111111111111110000000000001111111111111111111111111111111111111
1111111111111111111111111111000011111111111111111111111111000000111111111111111111111111000000000011111111111111111111111111111111111111
1111111111111111111111111111111111111111111111111111111111111111111111111111111111111111111111111111111111111111111111111111111111111111
