111111111111111111111111111111111111111111111111111111111111111111111111111111111111111111111111111111111111111111111111111111111111
111111111111111111111111111111111100000000001111111111111111111111001111111111111111111111110011111111111111000011111111111111111111
111111111111111111111111111111111000000000000111111111111111111100000000111111111111111111100001111111111110000001111111111111111111
111111111111111111111111111111000000000000000000111111111111111000000000011111111111111110000000001111110000000000001111111111111111
111111111111111011011111111110000000000000000000011111111111110000000000000111111111111110000000000111100000000000000111111111111111
111111111111000000000011111100000000000000000000001111111111100000220220000011111111111110000000000000000000000000000000111111111111
111111111110000000000001111000000000000000000000000111111111000002200022000001111111111110000000000000000000222000000000011111111111
111111110000000000000000111000000000000000000000000111111110002200000000022000111111111110000000000000000000222000000000000011111111
111111100000000000000000011000000000000000000000001111111100022000000000002200011111111112200000000000000000222000000000000001111111
111110000000000000000000011100022200000000000222001111111100000000000000000000011111111112220000000000000000000000000000000001111111
111100000000000000000000011100022200000000000222000111111100222000000000002220011111111122222000000000000000000000000000000001111111
111000000000000000000000011000022200000000000222001111111100222000000000002220001111111222222200000000000000000000000000000000111111
111000000222000000000000010000000000000000000000001111111100222000000000002220001111112222222220000000000000000000000000000000011111
110000000222000000000000010000000000000000000000001111111100000000000000000000001111100222222222000000000000000000000000000000011111
100000000222000000000000011000000000000000000000001111111100000000000000000000001111000022222222000000000000000000000000000000011111
100000000000000000000000001110000000000000000000001111111100000000000000000000000000000002222211100000000000000000000000000000001111
100000000000000000000000000111112000000000000000001111111100000000000000000000000000000000222111100000000000000000000002220000000111
100000000000000000000000000111122200000000000000011111111000000000000000000000000000000000021111100000000000000000000002220000000111
100000000000000000000000000111222100000000000002211111110000000000000000000000000000000000011111100000000000000000000002220000001111
100000000000000000000000000022221100000000000022211111100000000000000000000000000000000000011111100000000000000000000000000000011111
100000000000000000000000000022211100000000000222221111000000000000000000000000000000000000011111110000000000000000000000000000011111
100000000000000000000000000002211110000000002222222110000000000000000000000000000000000000000001111110000000000000000000000000011111
100000000000000000000000000000011110000000002222222200000000000000000000000000000000000000000000111111000000000000000000000000111111
100000000000000000000000000000001111100000011122222000000000000000000000000000000000000000000222011111111000000000000000000111111111
100000000000000000000000000000001111110000111112220000000000000000000000000000000000000000000222002211111100000000000000022111111111
100000000000000000000000000000011111111111111111200000000000000000000011111111111110000000000222022022111110000000000000222111111111
100000000222000000000000000000011111111111111111000000000000000000000011111111111111100000000000000000022111000000000002222211111111
100000000222000000000000000000011111111111111111000000000000000000000011111111111111100000000000000000002211100000000022222221001111
100000000222000000000000000000011111111111111111200000000000000000000211111111111111110000000000000000000011100000000222222222000111
100000000000000000000000000000011111111111111112220000000000000000002221111111111111110000000000000000002211100000002222222220000111
110000000000000000000000000000111111111111111122222000000000000000022222111111111111110000000000000000000221110000002222222200000011
111110000000000000000000000001100011110000002222222200000000000000222222220000111111110000000000000000002201111000011122222000000001
111111000000000000000000000011000000000000002222222220000000000002222222220000111111110000000000000000000000111100111112220000000001
111111111000000000000000011110000000222000000222222222001111111022222222200000011111110000000000000000002220111111111111200000000011
111111111100000000000000111000000000222000000022222221111111111112222222000000000111110000000000000000002220011111111111000000000111
111111111111100000000001110000000000222000000002222211111111111111222220000000000011100000000000000000002220000011110000000000000111
111111111111110000000001100000000000000000000000222111111111111111122200000000000001000000000000000000000000000002000000000000000111
111111111111111111111111000000000000000000000000022111111111111111122000000000000001000000000000000000000000000002000000000000001111
111111111111111111111111000000000000000000000000000111111111111111100000000000000011000000000000000000000000000022000000000000001111
111111111111111111111111000000000000000000000000000011111111111100000000000000000110000000000000000000000000000022000000000000001111
111111111111111111111110000000000000000000000000000001111111111000000000000000000100000000000000000000000000000020000000000000001111
111111111111111111111110000000000000000000000000000000001111110000000000000000000100000000000000000000000000002220000000000000001111
111111111111111111111110000000000000000000000000000000000111100000000000000000001100000000111100000000000000002200000000000000011111
111111111111111111111100022200000000000000000000000000000022000000000000000111111000000000111100000000000000022200000000000000011111
111111111111111111111000022200000000000000000000000000000022000000000000022111111000000000111100000000000111111111100000000000011111
111111111111111111111000022200000000000000000000000000000022000000000000222111111000000000111100000011111111111111110000000000011111
111111111111111111111110000000000000000000000000000000000022000000000002222211110000000000000000000011111111111111111000000000011111
111111111100001111111111000000000000000000011111100000000000000000000022222221100000000000000000000011111111111111111000000000011111
111111111000000111111111000000000000000000111111110000000000000000000222222222000000000000000000000211111111111111111000000000001111
111111000000000000111111000000000000000001111111111000000000000000001111222220000000000000000000002221111111111111111100000000001111
111110000000000000111111000000000000000221111111111220000000000000011111122200000000000000000000022222111111111111111100000000000111
111100000000000000011110000000000000002111111111111222000000000000211111122000000000000000000000222222221111111111111110000000000111
111000000000000000000000000000000000021111111111112222200000000000211111120000000000000000000002222222220111111111111110000000000111
111000000000000000000000000000000000211111111111122222220000000001111111100000000000000000000022222222200000111111111111000000000111
111000000000000000000000000000000002111111120000222222222000000011111111000000000000000000000222222222000000111111111111200000000011
110000000000000000000000000000000021111111200000022222222200000111111120000000000000000000002222222220000000111111111112220000000011
100000000000000000000000000000000211111112000000002222222211111111110000000000000000000000001222222200000000111111111122222000000111
100000000000000000000000000000002111111120000000000222221111111111100000000000000000000000011122222000000000011111112222222200001111
100000000000000000000000000000002111111200000000000022211111111111000000000000000000000000011112220000000000011111102222222220001111
100000000000000000000000000111111111112000000000000002111111111111000000000000000000000000011112200000000000001111000222222222011111
100002220000000000000000000111111111120000000000000000011111111111000000000000000000000000011111000000000000000000000022222221111111
100002220000000000000000000111111111200000000000000000001111111110000000000000000000000000011111100000000000000000000002222211111111
110002220000000000000000001111111111100000000000000000000111111110000000000000000000000000011111110000000000000000000000222111111111
111000000000000000000000011111111111100000000000000000000011111100000000000000000000000000001111111000000000000000000000022111111111
111000000222000000000000011111111111100000000000000000000002000000000000000011110000000000001111111000000000000000000000000111111111
111000000222000000000000011111111111110000000000000000000022000000000000000011111000000000000111111111100000000000000000000111111111
111100000222000000000000011111111111110000000000001111000220000000000000000011111100000000000111111111110000000000000000000111111111
111111100000000000000000011111111111110000000000001111102200000000000000000211111100000000000111111111111000000000000000000011111111
111111110000000000000000000111111111111000000000001111112000000000000000002201111100000000000011111111111110000000000000000001111111
111111111000000000000000000011111111111000000000001111110000000000000000022000111100000000000011111111111110000000000000222000001111
111111111000000000000000000001111111111000000000000111110000000000000000220000000000000000000011111111111110000000000000222000000111
111111111000000000000000000000000111111100000000000011110000000000000000200000000000000000000001111111111110000000000000222000000111
111111111220000000000000000000000111111100000000000000000000000000001111110000000000000000000001111111111110000000000000000000000111
111111111222000000000000000000000011111110000000000000000000000000011111111000000000000000000001111111111100000000000000000022200011
111111112222200000000000000000000001111110000000000000000000000000011111111100000000000000000002111111111000000000000000000022200001
111111122222220000000000000000000000111110000000000000000000000000111111111110000000000000000021111111111000000000000000000022200001
111110222222222000111100000000000002211110000000000000000000000000111111111111200000000000000211111111111000000000000000000000000001
111100022222222201111110000000000022211110000000000000000000000000111111111112220000000000002111111200000000000000000000000000000001
111100002222222211111110000000000222221110000000000000000000000001111111111122222000000000021111111200000000000000000000000000000001
111000000222221111111111000000002222222100000000000000000000000011111111112222222200000000211111112000000000000000000000000000000001
110000000022211111111111000000022222222200000000000000000000021111111000002222222220000002111111120000000000000000000000000000000011
110000000002111111111111000000222222222000000000000000000000111111110000000222222222000021111111200000000000000000000000000000000111
111000000000111111111111000002222222220000000000000000000001111111100000000022222221111111111112000000000000000000000000000000000111
111000000000011111111111111022222222200000000000000000000021111112000000000002222211111111111120000000000000000000000000000000000111
111000000000011111111111111122222222000000000000000000000221111112000000000000222111111111111200000000000000011110000000000000001111
111000000000001111111111111111222220000000000000000000002221111110000000000000022111111111122000000000000000111111000000000000011111
111100000000001111111111111111122200000000000000000000022222111100000000000000000111111111100000000000000000111111000000000000111111
111100000000000111111111111111112000000000000000000000222222222000000000000000000011111111000000000000000000111111111000000111111111
111110000000000111111111111111110000000000000000000001122222220000000000000000000001111110000000000000000000111111111100001111111111
111110000000000111111111111111110000000000000000000011112222200000000000220000000000000000000000000000000000011111111111111111111111
111110000000000011111111111111110000001111000000000111111222000000000000220000000000000000000000000000002220000111111111111111111111
111110000000000001111111111000000000001111000000000111111220000000000000220000000000000000000000000000002220000111111111111111111111
111110000000000000000220000000000000001111000000000111111000000000000000220000000000000000000000000000002220001111111111111111111111
111110000000000000002220000000000000001111000000001100000000000000000001111000000000000000000000000000000000011111111111111111111111
111100000000000000002200000000000000000000000000001000000000000000000011111100000000000000000000000000000000011111111111111111111111
111100000000000000022000000000000000000000000000001000000000000000000111111111100000000000000000000000000000011111111111111111111111
111100000000000000220000000000000000000000000000011000000000000000001111111111110000000000000000000000000000111111111111111111111111
111100000000000000220000000000000000000000000000110000000000000001111111111111111000000000000000000000000000111111111111111111111111
111100000000000000220000000000000000000000000000100000000000000221111111111111111220000000000000000000000000111111111111111111111111
111000000000000000200000000000000000000000000000100000000000002221111111111111111222000000000000000000000001100000000011111111111111
111000000000000011110000022200000000000000000001110000000000022222111111111111112222200000000222000000000011100000000001111111111111
111000000000111111111110022200000000000000000011111000000000222222211111111111122222220000000222000000000111000000000000001111111111
110000000002111111111111022200000000000000000011111110000002222222220111111100222222222000000222000000011110000000000000000111111111
100000000022211111001111000000000000000000000011111111000022222222200000000000022222222200000000000000110000000000000000000000111111
100000000222221110000111102200000000000000000011111111000022222222000000000000002222222200000011110001100000000000000000000000011111
110000002222222200000011122000000000000000000011111111111111222220000000000000000222221111111111111111000000000000000000000000000011
111000022222222200000001112200000000000000000011111111111111122200000000000000000022211111111111111110000000000000000000000000000001
111000222222222000000001110000000000000000000011111111111111112000000000000000000002111111111111111110000000000000000000222000000001
111100122222220000000001112200000000000000000001111111111111110000000000000000000000111111111111111110000000000000000000222000000001
111111112222200000000000111220000000000000000001111111111111110000000000000000000000111111111111111110000000000000000000222000000001
111111111222000000000000011111220220222000000000011111111111110000000000000000000002111111111111111110000000000000000000000000000001
111111111220000000000000001111112200222000000000000000000000000000000000000000000022211111000011111100000000000000000000000000000001
111111111000000000000000000111111110222000000000000000000000000000000000000000000222221110000001111100000000000000000000000000000001
111111000000000000000000000000111111000000000000000000000000000000000000000000002222222200000000011110000000000000000000000000000001
111110000000000000000000000000011111100000000000000000000000000000000000000000011222222200000000011112200000000000000000000000000001
111110000000000000000000000000000011111110000000000000000000000000000000000000111122222000000000001112220000000000000000000000000001
111110000000000000000000000000000001111110000000000000000000000000000000000001111112220000000000001122220000000000000000000000000001
111100000022200000000000000000000001111110000000000000000000000000000000000011111112200000000000001222111000000000000000000000000001
111000000022200000000000000000000001111120000000000000000000000000000000000111111110000000000000002221111000000000000000000000000001
111000000022200000000000000000000001111222000000000000000000000000000000001111111100000000000000000211111000000000000000000000000001
111100000000000000000000000000000001112222200000000000000000000000000000001111111100000000000000000000011100000000000000000000000001
111110000000000000000000000000000000222222220000111100000000000000000000001111111100000000000000000000000110000000000000222000000001
111110000000000000000000000000000000222222222001111100000000000000000000001111111100000000000000000000000010000000000000222000000011
111110000000000000000000000000000000022222222211111100022200000000000222001111111100000000000000000000000010000000000000222000000111
111111000000000000000000000000000000002222222111111100022200000000000222001111111100222000000000002220000110000000000000000000000111
111111100000000000000000000000000000000222221111111110022200000000000222001111111000222000000000002220001110000000000000000000001111
111111100000000000000000000000000000000022211111111110000000000000000000001111111100222000000000002220001110000000000000000000011111
111111100000000000000222000000000000000002211111111110002200000000000220001111111100000000000000000000000110000000000000000001111111
111111110000000000000222000000000000000000011111111111000220000000002200011111111000000000000000000000000111000000000000000011111111
111111111110000000000222000000000000000000011111111111100000220002200000111111111000000000000000000000000111100000000000011111111111
111111111111000000000000000000000000000000011111111111110000022022000001111111111100000000000000000000001111110000000000111111111111
111111111111111000000000000001111000000000011111111111111000000000000011111111111110000000000000000000011111111110110111111111111111
111111111111111100000000000011111100000000011111111111111110000000000111111111111111000000000000000000111111111111111111111111111111
111111111111111111100000011111111111100001111111111111111111000000001111111111111111111000000000000111111111111111111111111111111111
111111111111111111110000111111111111110011111111111111111111111100111111111111111111111100000000001111111111111111111111111111111111
111111111111111111111111111111111111111111111111111111111111111111111111111111111111111111111111111111111111111111111111111111111111
