22222222222222222222222222222222000000000000000000000000222222222222222222222222222222222222222222222222220000000000000000000000
22222222222222222322222222222200000000000000000000000002222222222222222222222222222222222222222222222222000000000000000000000000
22222222222222222222222222220000000000000000000000000022222222222222222222222222222222222222222222222220000000000000000000000000
22222222222222222222222222200000000000000000000000000000022222222222222222222222222222222222222222222220000000000000000000000000
22222222222222222222222222220000000000000000000000000000022222222222222222222222222222222222222222222222200000000000000000000000
22222222222222222222222222222000000000000000000000000000022222222222222222222222222222222222222222222222200000000000000000000000
22222222222222222222222222222000000000000000000000000000002222222222222222222222222222222222222222222222200000000000000000000000
22222222222222222222222222222000000000000000000000000000000222222222222222222222222222222222222222222222200000000000000000000000
22222222222222222222222222220000000000000000000000000000000022222222222222222222222222222222222222222222220000000000000000000000
22222222222222222222222222220000000000000000000000000000000000000222222222222222222222222222222222222222200000000000000000000000
22222222222222222222222222200000000000000000000000000000000000110222222222222222222222222222222222222222200000000000000000000000
22222222222222222222222222220000000000000000000000000000000000112222222222222222222222222222222222222222200000000000000000000000
22222222222222222222222222222000000000000000000000000000000000002222222222222222222222222222222222222222220000000000000000000000
22222222222222222222222222222220000000000000000000000000000000022222222222222222222222222222222222222222000000000000000000000000
22222222222222222222222222222220000000000000000000000000000000022222222222222222222222222222222222222220000000000000000000000000
22222222222222222222222222222222000000000000000000000000000000002222222222222222222222222222222222222222000000000000000000000000
22222222222222222222222222222220000000000000000000000000000000002022222222222222222222222222222222222222000000000000000000000000
22222222222222222222222222222222000000000000022000000000000000022222222222222222222222222222222222222222200000000000000000000000
22222222222222222222222222222222200000000000222220000000000000022222222222222222222222222222222222222222200000000000000000000000
22222222222222222222222222222222220002200002222222200000000000000222222222222222222222222222222222222222000000000000000000000000
22222222222222222222222222222222222222222002222222200000000000000222222222222222222222222222222222222200000000000000000000000000
22222222222222222222222222222222222222222222222202200000000000002222222222222222222222222222222222200000000000000000000000000000
22222222222222222222222222222222222222222222222000000000000000000000222222222222222222222222222222000000000000000000000200022000
22222222222222222222222222222222222222220222022200000000000000000002222222222222222222222222222200000000000000000020022222222220
22222222222222222222222222222222222222000000000000000000000000000022222222222222222222222222222220000000000000000222222222222222
22222222222222222222222222222222222222000000000000000000000000000000222222222222222222222222222222000220000000200222222222222222
22222222222222222222222222222222222200000000000000000000000000000000022222222222222222222222222222222222000222222022222222222222
22222222222222222222222222222222220000000000000000000000000000000000022222222222222222222222000002222222222222222222222222222222
22222222222222222222222222222222000000000000000000000000000000000000002222222222222222222200000000222202222222222222222222222222
22222222222222222222222222222200000000000000000000000000000000000000000022222222222022200000000000000000222222222222222222222222
22222222222222222222222222220000000000000000000000000000000000000000000000000022200000000000000000000000022222222222222222222222
22222222222222222222222222000000000000000000000000000000000000000000000000000000000000000000000000000000022222222222222222222222
22222222222222222222222200000000000000000000000000000000000000000000000000000000000000000000000000000000222222222222222222222222
22222222222222222222220000000000000000000000000000000000000000000000000000000000000000000000000000000002222222222222222222222222
22222222222222222222000000000000000000000000000000000000000000000000000000000000000000000000000000002022222222222222222222222222
22222222222222222200000000000000000000000000000000000000000000000000000000000000000000000000000002222222222222222222222222222222
33222222222222220000000000000000000000000000000000000000000000000000000000000000000000000000000022222222222222222222222222222222
33222222222220000000000000000000000000000000000000000000000000000000000000000000000000000000000222222222222222222222222222222222
22222222222222000000000000000000000000000000000000000000000000000000000000000000000000000000000222222222222222222222222222222222
22000000002222200000000000000000000000000000000000000000000000000011000000000000000000000000000222222222222222222222222222222222
00000000000022222000000000000000000000000000000000000000000000000011000000000000000000000000002222222222222222222222222222222222
00000000000000222000000000000000000000000000000000000000000000000000000000000000010000000000000222222222222222222222222222222222
00000000000000222200000000000000000000000000000000000000000000000000000000000000000000000000002222222222222222222222222222222222
00000000000002222000000000000000000000000000000000000000000000000000000000000000000000000000002222222222222222222222222222222222
00000000000002222200000000000000000000000000000000000000000000000000000000000000000000000000022222222222222222222222222222222222
00000000000000222200000000000000000000000000000000000000000000000000000000000000000000000000222222222222222222222222222222222222
00000000000000002220000000000000000000000000000000000000000000000000000000000000000000000000022222222222222222222222222222222222
00000000000000002220000000000000000000000000000000000001000000000000000000000000000000000000022222222222222222222222222222222222
00000000000000022220000000000000000000000000000000000000000000000000000000000000000000000000022222222222222222222222222222222222
00000000000000022222000000000000000000000000000000000000000000000000000000000011000000000000222222222222222222222222222222222222
00000000000000022222000000000000000000000000000000000000000000000000000000000011000000000000002222222222222222222222222222222222
00000000000000002222200000000000000000000000000000000000000000000000000100000000000000000000000222222222222222222222222222222222
00000000000000001122220000000000000000000000000000000000000000000000000000000000000000000000002222222222222222222222222222222222
00000000000000001102220000000000000000000000000000010000000000000000000000000000000000000000000022222222222222222222222222222222
00000000000000000002222000000000000000000000000000000000000000000000000000000000000000000000000000222222222222222222222222222222
00000000000000000002222000000000000000000000000000000000000000000000000000000000000000000000000000022222222222222222222222222222
00000000000000000002222000000000000000000000000000000000000000000000000000000000000000000000000000222222222222222222222222222222
00000000000000000000022200000000000000000000000000000000000000000000000000000000000000000000000000000222222222222222222222222222
00000000000000000000022000000000000000000000000000000000000000000000000000000000000000000000000000000002222220222222222222222222
00000000000000000000222200000000000000000000000000000000000000000000000000000000000000000000000000000000000000000220222222222222
00000000000000000000000000000000000000000000000000000000000000000000000000000011100000000000000000000000000000000000022222222222
00000000000000000000000000000000000000000000000000000000000000000000000000000011110000000000000000000000000000000000002222222222
00000000000000000000000000000000000000000000000000000000000000000000000000000011100000000000000000000000000000000000000000022222
00000000000000000000000000000000000000000000000000000000000000000000000000000000000000000000000000000000000000000000000000002220
00000000000000000000000000000000000000000000000000000000000000000000000000000000000000000000000000000000000000000000000000000000
02200000200000000000000000000000000000000000000000000000000000000000000000000000000000000000000000000000000000000000000000000000
22222002220000000000000000000000000000000000000110000000000000000000000000000000000000000000000000000000000000000000000000000000
22222222222200000000000000000000000000000000001111000000000000000000000000000000000000000000000000000000000000000000000000000000
22222222222200000000000000000000000000000000000111000000000000000000000000000000000000000000000000000000000000000000000000000000
22222222222002000000000000000000000000000000000000000000000000000000000000000000000000000000000000000000002000000000000000000000
22222222222222222000200220000000000000000000000000000000000000000000000000000000000000000000000000000000022200000000000000000000
22222222222222222222222222200000000000000000000000000000000000000000000000000000000000000000000000000000022220000000000000000000
22222222222222222222222222220000000000000000000000000000000000000000000000000000000000000000000000000000022222000000000000000000
22222222222222222222222222222000000000000000000000000000000000000000000000000000000000000000000000000000022200000000000000000000
22222222222222222222222222222000000000000000000000000000000000000000000000000000000000000000000000000000022220000000000000000000
22222222222222222222222222222220000000000000000000000000000000000000000000000000000000000000000000000000022222000000000000000000
22222222222222222222222222222222000000000000000000000000000000000000000000000000000000000000000000000000002222200000000000000000
22222222222222222222222222222222200000000000000000000000000000000000000000000000000000000000000000000000000222200000000000000000
22222222222222222222222222222222200000000000000000000000000000000000000000000000000000000000000000000000002222200000000000000000
22222222222222222222222222222222220000000000000000110000000000000000000000000000000000000000000000000000000022220000000000000000
22222222222222222222222222222222222000000000000000110000000000000000000001000000000000000000000000000000000002222000000000000000
22222222222222222222222222222222222000000000000000000000000000000000000000000000000000000000000000000000000022222200000000000000
22222222222222222222222222222222222000000000000000000000000000000000000000000000000000000000000000000000000000022220000000000000
22222222222222222222222222222222222000000000000000000000000000000000000000000000000000000000000000000000000000022220000000000000
22222222222222222222222222222222222000000000000000000000000000000000000000000000000000000000000000000000000000022220000000000000
22222222222222222222222222222222222200000000000000000000000000000000000000000000000000000000000000000000000000222200000000000000
22222222222222222222222222222222220000000000000000000000000000000000000000000000000000000000000000000000000002222200000000000000
22222222222222222222222222222222200000000000000000000000000000000000000000000000000000000000000000000000000022222220000000000000
22222222222222222222222222222222220000000000000000000000000000000000000000000000000000000000000000000000000000222222000000002000
22222222222222222222222222222222200000000000000000000000110000000000000000000000000000000000000000000000000000002222222002222222
22222222222222222222222222222222200000000000000000000000110000000000000000000000000000000000000000000000000000000022222222222222
22222222222222222222222222222222200000000000000000000000000000000000000000000000000000000000000000000000000000002002222222222222
22222222222222222222222222222222220000000000000000000000000000000000000000000000000000000000000000000000000000022202222233222222
22222222222222222222222222222222000000000000000000000000000000000000000000000000000000000000000000000000000002222222222233222222
22222222222222222222222222222200000000000000000000000000000000000000000000000000000000000000000000000000000222222222222222222222
22222222222222222222222220000000000000000000000000000000000000000000000000000000000000000000000000000000022222222222222222222222
22222222222222222222222222000000000000000000000000000000000000000000000000000000000000000000000000000002222222222222222222222222
22222222222222222222222000000000000000000000000000000000000000000000000000000000000000000000000000000222222222222222222222222222
22222222222222222222222000000000000000000000000200000000000000000000000000000000000000000000000000022222222222222222222222222222
22222222222222222222222200000000000000000220002222000220000000000000000000000000000000000000000002222222222222222222222222222222
22222222222222222222222220022000000000002222222222222222200000000000000000000000000000000000000222222222222222222222222222222222
22222222222222222222222222222220000002222222222222222222220000000000000000000000000000000000022222222222222222222222222222222222
22222222222222022222200222222222200222222222222222222222222000000000000000000000000000000002222222222222222222222222222222222222
22222222222222202222000022200222222222222222222222222222222200000000000000000000000000000222222222222222222222222222222222222222
22222222222222200000000000000022222222222222222222222222222200000000000000000002200220022222222222222222222222222222222222222222
00002222222222220000000000000000222222222222222222222222222220000000000000200222222222222222222222222222222222222222222222222222
00000022220000000000000000000002222222222222222222222222222220000000000002222222222222222222222222222222222222222222222222222222
00000000000000000000000000000222222222222222222222222222222200000000000002222222222222222222222222222222222222222222222222222222
00000000000000000000000000022222222222222222222222222222222200000000000000222202222200222222222222222222222222222222222222222222
00000000000000000000000002222222222222222222222222222222222220000000000000000000222220000022222222222222222222222222222222222222
00000000000000000000000022222222222222222222222222222222222222000000000000000000000200000000222222222222222222222222222222222222
00000000000000000000000222222222222222222222222222222222222220000000000000000000000000000000002222222222222222222222222222222222
00000000000000000000000222222222222222222222222222222222222222000000000000000000000000000000000022222222222222222222222222222222
00000000000000000000000022222222222222222222222222222222222222200000000000000000000000000000000002222222222222222222222222222222
00000000000000000000000002222222222222222222222222222222222222220000000000000000000000000000000002222222222222222222222222222222
00000000000000000000000002222222222222222222222222222222222222222000000000000000000000000000000022222222222222222222222222222222
00000000000000000000000222222222222222222222222222222222222222222000000000000000000000000000000002222222222222222222222222222222
00000000000000000000000222222222222222222222222222222222222222200000000000000000000000000000000000222222222222222222222222222222
00000000000000000000002222222222222222222222222222222222222222200020000000000000000000000000000000222222222222222222222222222222
00000000000000000000000222222222222222222222222222222222222222220222000000000000000000000000000000022222222222222222222222222222
00000000000000000000000222222222222222222222222222222222222222222222220000000000000000000000000000222222222222222222222222222222
00000000000000000000000222222222222222222222222222222222222222222222220000000000000000000000000002222222222222222222222222222222
00000000000000000000000222222222222222222222222222222222222222222222200000000000000000000000000022333322222222222222222222222222
00000000000000000000000222222222222222222222222222222222222222222222222000000000000000000000000222333322222222222222222222222222
00000000000000000000000222222222222222222222222222222222222222222222222000000000000000000000000022222233222222222222222222222222
00000000000000000000000022222222222222222222222222222222222222222222222000000000000000000000000022223333222222222222222222222222
00000000000000000000000002222222222222222222222222222222222222222222222220000000000000000000000002223322222222222222222222222223
00000000000000000000000022222222222222222222222222222222222222222222222222200000000000000000000022222222222222222222222222222222
