00000000000000002200000000001111111111111100000000000021110000000000000000000000000000000000000000001111112222222222000000000000
12222200222200002100000000111111111111110000222222220011110000000000000000000000000222200000000000001111002222222202222002222000
00222202200220000000000011111111111111110002200220022011111100000000000000000000000222200220000000001111222222222222002202222000
00000000000000000000000011111111111111110000000000000000111100000000000000000000000000000022000000001111222222222200000000000000
00220000000000000000000000111111111111110000000000000000111112220000000000000000000000000002200000000011122222222200000000022000
02200000000000000000000000111111111111112222000000000000111112220000000000000000000000000000000000000011112222222200000000002200
00000000000000000000000000111111111111002222000000000000001122110000000000000000000000000002200000000011112222220000000000000000
02200000000000000000000000111111111111000000000000000000002221111100000000000000000000000022000000000011112222220000000000002200
00220000000000000000000011111111111111110000000000000000002211111111000000000000000000000002200000000011110022222200000000022000
00000000000000000000000011111111111111110000000000000000002211111111000000000000000000000022000000000011112222222200000000000000
00000000000000000000000011111111111111110000000000000000000000111111000000000000000000000000000000000011112222222200000000000000
00000000000000000000000011111111111111111100000000000000000000111111000000000000000000000022000000000011112222222222220000000000
00000000000000000000000000111111111111111111000000000000000000211100000000000000000000000220000000001111112222222222000000000000
00000000000000000000000011121111111111111111000000000000000000111100000000000000000000000000000000001111222222222200000000000000
00000000000000000000000011111111111111111111000000000000000000111111000000000000000000000000000000001111222222222200000000222200
00000000000000000000000011111111111111111111000000000000000000001111110000000000000000000000000000001111222222222222222222222222
00000000000000000000000021221111111111111111000000000000000000211111110000000000000000000000000000000011122222222222222222222222
00000000000000000000000000001111111111111111111100000000000000111111000000000000000000000000000000000011112222222222222222222222
00000000000000000000000000000011111111111111111111000000000000111111000000000000000000000000000000001111112222222222222222222222
00000000000000000000000000000000111111111111111111120000000000001111110000000000000000000000000000111111222222222222222222222222
00000000000000000000000000000000001111111111111111110000000000001111111100000000000000000000000011111122222222222222222222222222
00000000000000000000000000000000000211111111111111110000000000001111111100000000000000000000001111112222222222222222220000000022
00000000000000000000000000000000002211111111111100000000000000000021110000000000000000000000111111112222222222220002201111111100
00000000000000000000000000000000222221111111111100000000000000000011110000000000000000000000111100112222222222222111111111111111
00000000000000000000000000000022222222200000000000000000000000000011111100000000000000000000111111000222222200201111110000000011
00000000000000000000000000002222222222200000000000000000000000000000111100000000000000000011111111111111222011111111110000000000
00000000000000000000000000222222222222000000002222000000000000000000111100000000000000001111111111111111111111111111110000000000
00000000000000000000000022222222222200002222222222220000000000000000111111111100001111111111000011111111111100001111000000000000
00000000000000000000002222222222220000222222222222220000000000000000001111111111111111111100000000111111111100000000000000000000
00000000000000000000222222222222000022222222222222220000000022220000000011111111111111112200000000000000111100000000000000000000
00000000000000000022222222222200000022222222222222220000002222222200000000000011110000000222200000000000111100000000000000000000
00000000000000002222222222220000000000222222222222000000222222222222000000000000000000000000000000000000111100000000000000000000
00000000000000222222222222000000002222222222000000000022222222002222222222000000000000000000002200000021110000000000000000000000
00000000000022222222222200000000222222222200000000002222222222222222222222000000000000000000000000000011110000000000000000000000
00000000000011222222220000222222222222220000000000222222222222222222222222000000000000000000022000111111110000000000000000000000
11000000001111122222000022222222222222220000000000222222222222222222222222000000000000000000002211111111000000000000022220000000
11000000001111112200002222222222222222222200000000000000222222222222222222000000000000000000002111000000000000000000022220022000
11111111111111112000002222222200002222222200000000000000002222222222222222220000000000000000001111000000000000000000000000002200
11111111111111000000000022222200002222222200000000222200000022222211222222220000000000000000001111000000000000000000000000000220
11111111111111110000000022222222222222222222000000222222222222222211222222002222000000000000001111000000000000000000000000002200
11111111111111111200002222222222222222222222000000222222222222222211222222222222220000000000001111000000000000000000000000000000
11111111111111111100222222222222222222220000000012222222222222222222222222222222210000000000001111000000000000000000000000002200
11111111111111111100222222222222222222220000000000002222222222222222222222222222220000000000001111000000000000000000000000000220
11111111111111111100002222222222222222000000000000000022222222222222222222222222222200000000211100000000000000000000000000000000
11111111111111111100000000222222222200000000000000000000222222222222222222222222222200000000111100000000000000000000000000000220
11111111111111111112000022222200222200000000000000000000000000222222222222222222222200000000111100000000000000000000000000002200
11111111111111111111002222222222222222000000000000000022000000222222222222222222222200000000111100000000000000000000000000022000
11111111111111111111002222222222222222000000000000000011000000222200002222222222222200000000111100000000000000000000000000000000
11111111111111111111000022222222222200000000000000000000000000000000002222222211222222000000111100000000000000000000000000000000
11111111111111111111000000000022220000000000000000000000000000000000002222222211222222000000111111000000000000000000000000000000
11111111111111111111120000000000000000000000000000000000002222000000002222222211222222000000221111000000000000000000000000000000
11110000111100001111110000000000000000000000000000002222222222220000002100222222222222220000121111000000000000000000000000000000
11000222200000001111110000000000000000000000000000222222222222220000000000222222222222222200001111110000000000000000000000000000
00000222200000001111111200000000000000000000000000210000002222000000000022222222222222222222000011111100000000000000000000000000
00000000000000000011111100000000000000000000000000000000000000000000000022222222222222222222000000111100000000000000000000000000
00000000000000000011111100000000000000000000000000000000000000000000000022222222222222222200000000111100000000000000000000000000
02200000000000000011111100000000000000000000000000000022222222000000000022222222222222222221000000111111111111110000000000000000
00220000000000000000211100000000000022220000000022222222222222220000000022222222222222222222000000001111111111111111111222000000
02200000000000000000111100000000002222220000002222222222222222222200002222222222222222222222000000000011111111111111111222000000
00220000000000000000111100000000002222000000002222222222222222222222222222222222222222222222000000000000000000001111112211000000
00220000000000000000000000000000002100000022222222222222222222222222222222222211112222222222000000000000000000000000222111110000
02200000000000000000000000000000000000002222222222222222222222222222222222222211112222222200000022220000000000000000221111111111
00220000000000000000000000000000000000002222222222222222222222222222222222222211112222222200002222220000000000000000221111111111
00000000000000000000000000000000000000002222222222222222222222222222222222222222222222222200002222000000000000000000000000001111
00000000000000000000000000000000000000222222222222222222222222222222222222222222222222220022220000000000000000000000000000000000
11110000120000000000000000000000000011222222222222222222222222222222222222222222222222220022222200000000000000000000000000002200
11111111122200000000000000000000000000222222221111222222222222222222222222222222222222220000222200000000000000000000000000000220
00001111221110000000000000000000000022222222221111222222222222222222222222222222222222000000000000000000000000000000000000002200
00000022211100000000000000000000000022222222222111222222222222222222222222222222221100000000000000000000000000000000000000000220
00000022211111110000000000000000000022222222222222222222220000222222222222222222220000000000000000000000211100000000000000002200
00000000001111111111111111000000000022222222222222222222000000002222222222222222000000000000000000000000111112000000000000000220
00000000000000001111111111110000000000222222222222222222000000000022222222000000000000001200000000000000111111000000000000000220
00000000000000000000000000111200000000222222222222222222000000000000000000000000000000000000000000000000111111000000002222000000
00000000000000000000000000111100000022222222222222222222000000002222000000000000000000000000000000000000111100000000002222000000
00000000000000000000000000111100000022222222222222222222000000002222220000000000000000000000000000000000111111000000000000000000
00000000000000000000000000001111000000222222222222222200000000000022220022220000000000000000000000000000111111120000000000000000
00000000000000000000000000000011120000002222222222222200000000000022220022220000000000000000000000000000001111110000000000001111
00000000000000000000000000000011110000000022222222222222000000002222222200000000000000000000000000000000001111110011111111111111
00000000000000000000000000000011110000000022222222112222220000222222222200000000000000000000002222000000001111111111111111111111
00000000000000000000000000000000111200000022222222112222220022222200000022000000000000000000222222222222000011111111111111111111
00000000000000000000000000000000111100000000222222112222220022222200000011000000000000000022222222222222220011111111111111111111
00000022220000000000000000000000111100000000112222222222222200222200000000000000000000000022222222222222220011111111111111111111
00000022220000000000000000000000111100000000002222222222222200000000000000000000000000000000222200222222000000111111111111111111
00000000000000000000000000000000111100000000002222222222220000000000000000000000000000000000222222222200000000111111111111111111
00220000000000000000000000000000111100000000000022222222220000000000002222000000000000000022222222222222220000111111111111111111
02200000000000000000000000000011111100000000000000222222220000000000002222000000000000002222222222222222220021111111111111111111
00220000000000000000000000000011110000000000000000222222220000000000000000000000002222002222222222222222220011111111111111111111
02200000000000000000000000000011110000000000000000222222222200000000000000000000222222222222222222222222220011111111111111111111
00000000000000000000000000000011110000000000000000002222112222000000000000000000222222222222222222222222000000111111111111111111
02200000000000000000000000000011110000000000000000002222112222000000000000000000002222222222220000222222000000001111111111111111
00220000000000000000000000000011110000000000000000002222112200000000000000000000000000222222220000222222220000000011111111221112
00220000000000000000000000000011110000000000000000000022222222220000000000000000222222222222222222222222220000021111110011111111
00022220000000000000000011111111110000000000000000000000222222220000000000000022222222222222222222222222000002221111110011221111
00000000000000000000001111111111000000000000000000000000222222220000000000000022222222222222222222222200000222222111000011112122
00000000000000000000001111111102200000000000000000000022222222222222220000000000222222222222222200000000022222222200000000000000
00000000000000000000001111000000000000000000000000000022222222222222220000002222000022222222220000000002222222220000000000000000
00000000000000000000111111000022000000000000000000000000000022222222000000222222222222222200000000000222222222000000000000000000
00000000000000000000111111000002200000000000000000000000000000222222000000222222222222222222000000022222222200000000000000000000
00000000000000000000111111000000000000000000001111000000000000002222000000002222222222222222000002222222220000000000000000000000
00000000000000000000111100000000002200221111111111111111000000000000000000002222222222222200000222222222000000000000000000000000
00000000000011110000111111111100000220111111110000111111110000000000000000002222222222220000022222222200000000000000000000000000
00000000001111111111111111111111000011110000000000000000111200000000000000000022222222000002222222220000000000000000000000000000
11110000001111111111111111111111111111000000000000000000111100000000000000000000000000000222222222000000000000000000000000000000
11111100001111121111222211111111111100000000000000000000111100000000000000000000000000022222222200000000000000000000000000000000
11111111111111110022222222001111111100000000000000000000001112000000000000000011111111111222220000000000000000000000000000000000
22221111111111112222222222221100111100000000000000000000001111000000000021111111111111111122000000000000000000000000000000000000
22222211112222222222222222220011110000000000000000000000111111000000000011111111111111111120000000000000000000000000000000000000
22222222222222222222222222001111000000000000000000000000111100000000000011111111111111111100000000000000000000000000000000000000
22222222222222222222222200111100000000000000000000000000001112000000000000111111111111111111000000000000000000000000000000000000
22222222222222222222220011110000000000000000000000000000001111000000000000000000111111111111110000000000000000000000000000000000
22222222222222222222222111000000000000000000000000000000001111000000000000000000001111111111111100000000000000000000000000000000
22222222222222222222221111000000000000000000000000000000001111000000000000000000001111111111111111000000000000000000000000000000
22222222222222222222221111110000000000000000000000000000001111000000000000000000001111111111111111110000000000000000000000000000
00000000000000222222222211110000000000000000000000000000000011110000000000000000000011111111111111110000000000000000000000000000
00000000000000222222222211110000000000000022220000000000000000111200000000000000000011111111111111110000000000000000000000000000
00000000000022222222222211110000000000220022220000000000000000111100000000000000000011111111111111110000000000000000000000000000
00000000022022222222002111000000000002200000000000000000000011111100000000000000000000111111111111110000000000000000000000000000
00000000000000222222201111000000000022000000000000000000000011110000000000000000000000111111111111111100000000000000000000000000
00220000000000222222201111000000000002200000000000000000000011110012000000000000000000111111111111111100000000000000000000002200
02200000000000222222201111000000000000000000000000000000000011111112220000000000002222111111111111111100000000000000000000000220
02200000000000222222221111000000000002200000000000000000000000111122111000000000002222111111111111111100000000000000000000000000
00220000000022222222221111000000000022000000000000000000000000002221110000000000000000111111111111112200000000000000000000000220
00000000000022222222221111000000000002200000000000000000000000000221110000000000000000111111111111111100000000000000000000002200
02222022002200222222221111000000000000000000000000000000000000000000111200000000002200111111111111111100000000000000000000000000
02222002222000222222221111110000000002200000000000000000000000000000111100220220022011111111111111111111000000000002200220222200
00000000000000222222221111110000000000220000000000000000000000000000111100002222220011111111111111111111000012000000222200222222
11111000000000222222221111110000000000000000000000000000000000000000001111000000000011111111111111111100001100000000000000011111
11111111111111111111111111111111111111111111111111111111111111111111111111111111111111111111111111111111111111111111111111111111
