00000000000000000000000000000000000000000000000000000000000000000000000000000000000000000000000000000000000000000000000000000000
00220000000000222200000000000000000000000000000000000000000000000000000000000000000000000000000000000000000000222200000000002200
02200000000000222200000000000000000000000000000000000000000000000000000000000000000000000000000000000000000000222200000000000220
00220000000000000000000000000000000000000000000000000000000000000000000000000000000000000000000000000000000000000000000000002200
00220000000000000000000000000000000000000011110000000000000000000000000000000000001111000000000000000000000000000000000000002200
02200000000000000000000000000000000011111111111100000000000000000000000000000000111111111111000000000000000000000000000000000220
00000000000000000000000000000011110011111111111111111100000000000000000000111111112222111111001111000000000000000000000000000000
02200000000000000000000000000011111111112211122211111100000000000000000000111111222222221111111111000000000000000000000000000220
02200000000000000000000000111111111111222222222222111100000000000000000000111122222222222211111111111100000000000000000000000220
00220000000000000000111100111111222222222222222222221111000000000000000011112222222222222222222211111100111100000000000000002200
00000000000000000000111111111122222222222222222222221111220000000000002211112222222222222222222222111111111100000000000000000000
00000000000000000000111111112222222222222222222222221111022000000000022011112222222222222222222222221111111100000000000000000000
00000000000000000000001111222222222222222222222222222211110000000000001111222222222222222222222222222211110000000000000000000000
00000000000000000000111111222222222222222222222222222211112222222222221111222222222222222222222222222211111100000000000000000000
11000000000000000000111111222222222222222222222222222211111111222211111111222222222222222222222222222211111100000000000000000011
11110000111100001111111122222222222222222222222222222222111111111111111122222222222222222222222222222222111111110000111100001111
11110000111111001111112222222222222222222222222222222222222222111122222222222222222222222222222222222222221111110011111100001111
11110000111111111111112222222222222222222222222222222222222222222222222222222222222222222222222222222222221111111111111100001111
11110000111111111111111122222222222222222222222222222222222222222222222222222222222222222222222222222222111111111111111100001111
11110000111111111111111111222222222222222222222222222222222222222222222222222222222222222222222222222211111111111111111100001111
11110000111111111122221111112222222222222222222222222222222222222222222222222222222222222222222222221111112222111111111100001111
11110000111111112202202211111122222222222222222222222222222222222222222222222222222222222222222222111111220220221111111100001111
11000000001111000000000022111122222222222222222222222222222222222222222222222222222222222222222222111122000000000011110000000011
00000000000000000000000000111122222222222222222222222222222222222222222222222222222222222222222222111100000000000000000000000000
00000000000000000000000000111111222222222222221122222222222222222222222222222222112222222222222211111100000000000000000000000000
11110000000000000000000022221111222222222222221122222222222222222222222222222222112222222222222211112222000000000000000000001111
11110000000000000000000022221111222222222222222222222222222222222222222222222222222222222222222211112222000000000000000000001111
11110000000000000000000000001111222222222222222222222222222222222222222222222222222222222222222211110000000000000000000000001111
11110000000000000000000000001111222222222222222222222222222222222222222222222222222222222222222211110000000000000000000000001111
00000000000000000000000000001111222222222222222222222222222222222222222222222222222222222222222211110000000000000000000000000000
00000000000000000000000000001111222222222222222222222222222222222222222222222222222222222222222211110000000000000000000000000000
00000000000000000000000000001111222222222222222222222222222222222222222222222222222222222222222211110000000000000000000000000000
00000000000011110000000000001111222222222222222222222222222222222222222222222222222222222222222211110000000000001111000000000000
00000000222111111100000000001111122222222222222222222222222222111122222222222222222222222222222111110000000000111111122200000000
00000022222221111111000000000011222222222222222222222222222211111111222222222222222222222222222211000000000011111112222222000000
00002222222222111111000000002112222222222222222222222222222111111111122222222222222222222222222221120000000011111122222222220000
00222222222222111111000000001122222222222222222222222222222211000011222222222222222222222222222222110000000011111122222222222200
22222222222200001111000000002222222222222222222222222222222221122112222222222222222222222222222222220000000011110000222222222222
12222222220000111100000000002222222222222222222222222222222222111122222222222222222222222222222222220000000000111100002222222211
11122222000000111100000000000022222222222222222222222222222222222222222222222222222222222222222222000000000000111100000022222111
11112200000000111112220000000000222222222222222222222222222222222222222222222222222222222222222200000000002221111100000000221111
00000000000000001222222200000000002222222222222222222222222222000022222222222222222222222222220000000000222222210000000000000000
00000000000000002222222222000000000022222222222222222222222200000000222222222222222222222222000000000022222222220000000000000000
00000000000000002222222222220000000000222222222222222222220000000000002222222222222222222200000000002222222222220000000000000000
00000000000000000022222222222200000000002222222222222222000000000000000022222222222222220000000000222222222222000000000000000000
00000000000000000000222222222222000000000022222222222200000000000000000000222222222222000000000022222222222200000000000000000000
00000000000000000000002222222222220000000000222222220000000000222200000000002222222200000000002222222222220000000000000000000000
00220000000000000000000022222222222200000000002222000000000022222222000000000022220000000000222222222222000000000000000000002200
02200000000000000000000000222222222222000000000000000000002222222222220000000000000000000022222222222200000000000000000000000220
00000000000000000000000000002222222222220000000000000000222222222222222200000000000000002222222222220000000000000000000000002200
02200000000000000000000000000022222222222200000000000022222222222222222222000000000000222222222222000000000000000000000000000220
00220000000000000000000011110000222222222222000000002222222222222222222222220000000022222222222200001111000000000000000000000000
02200000000000000000000011111100002222222222220000222222222222000022222222222200002222222222220000111111000000000000000000000220
00220000000000000000000011111111000022222222222222222222222200000000222222222222222222222222000011111111000000000000000000002200
00000000000000000000000011111111120000222222221111222222220000111100002222222211112222222200001111111111000000000000000000000000
00000000000000000000000011111111110022222222211111122222000011111111000022222111111222222222001111111111000000000000000000000000
00000000000000000000000011111111112222222222111111112200001111111111110000221111111122222222221111111111000000000000000000000000
00000000111100000000000011111111002222222222000000000000111111111111111100000000000022222222220011111111000000000000111100000000
00111111111111111100002200111111002222222222220000000011111111111111111111000000002222222222220011111100220000111111111111111100
11111111000011111111220000001111002222222222222200001111111111111111111111110000222222222222220011110000002211111111000011111111
11000000000000001111000000000000002222000022222200111111111111111111111111111100222222002222220000000000000011110000000000000011
00000000000000001111000000000000002222222222220011111111111111111111111111111111002222222222220000000000000011110000000000000000
00000000000000001111000000000000000022222222001111111111111111111111111111111111110022222222000000000000000011110000000000000000
00000000000022211111000000000000000000222200111111111111111111111111111111111111111100222200000000000000000011111222000000000000
00000000000011222100000000000000000000000011111111111111111111111111111111111111111111000000000000000000000000122211000000000000
00000000001111122200000000000000000000001111111111111111111111111111111111111111111111110000000000000000000000222111110000000000
00000000111111112200000000000000000000111111111111111111111111111111111111111111111111111100000000000000000000221111111100000000
00000000111111000000000000000000222200111111111111111111111111111111111111111111111111111100222200000000000000000011111100000000
00000000001111000000000000000000222200111111111111111111111111111121111111111111111111111100222200000000000000000011110000000000
00000000000011110000000000000000000000111111111111111111111111111111111111111111111111111100000000000000000000001111000000000000
00000000000000111100000000000000022000111111111111111111111111111111111111111111111111111100022000000000000000111100000000000000
00000000000000001111000000000000220011111111111111111111111111111111111111121111111111111112002200000000000011110000000000000000
00000000000000001111000000000000000011111111111111111111111111222211111111111111111111111111000000000000000011110000000000000000
00000000000000001111000220002202200011111111111111111111000220222202222011111111111111111111000220220002200011110000000000000000
00000000000000000011110002222220001111111111111111111111022000000000000011111111111111111111110002222220001111000000000000000000
00000000000000000000111100000000111111111111111111111111000000000000022011111111111111111111111200000000111100000000000000000000
00000000000000000000001111111100111111111111111112111111220000000000002211111111111111111111111100111111110000000000000000000000
00000000000000000000000011111111111111111111111111111111022000000000000011111111111111111111111111111111000000000000000000000000
00000000000000000000000000000011111111111111111111111111000000000000000011111111111111111111111111000000000000000000000000000000
00000000000000000000000000000011111111111111111111111111000000000000000011111111111111111111111111000000000000000000000000000000
00220000000000000000000000000011111111111111111111111111110000000000001111111111111111111111111111000000000000000000000000002200
00220000000000000000000000000000111111111111111111111111110000000000001111111111111111111111111100000000000000000000000000002200
02200000000000000000000000000000111111111111111111111111110000000000001111111111111111111111111100000000000000000000000000000220
00000000000000000000000000000000111111111111111111111111110000000000001111111111111111111111111100000000000000000000000000000220
02200000000000000000000000000000111111111111111111111111111111111111111111111111111111111111111100000000000000000000000000000000
00220000000000000000000000000000111111111111111111111111111111111111111111111111111111111111111100000000000000000000000000000220
02200000000000000000000000000000001111211111111111111111111111111111111111111111111111111111110000000000000000000000000000002200
02200000000000000000000000000000001111111111111111111111111111111111111111111111111111111111110000000000000000000000000000000220
00220000000000000000000000000000111111111111111111111111111111111111111111111111111111111111111100000000000000000000000000002200
00000002222000000000000000000000111111111111111111111111111111111111111111111111111111111111111100000000000000000000022220000000
00000002222000000000000000000000111111111111111111111111111111111111111111111111111111111111111100000000000000000000022220000000
00000000000000000000000000000011111111111111111111111111111111111111111111111111111111111111111111000000000000000000000000000000
00000000000000000000000000000011111111111111111111111111111111111111111111111111111111111111111111000000000000000000000000000000
00000000000000000000000000000000111111111111111111111111111111111111111111111111111111111111111100000000000000000000000000000000
11111000000000000000000000000000111111111111111111111111111111111111111111111111111111111111110000000000000000000000000000011111
11111111111111111111111111111111111111111111111111111111111111111111111111111111111111111111111111111111111111111111111111111111
