22222222222222222222222222222222222222222222222222222222222222222222222222222222222222222222222222222222222222222222222222222222
22222222222222222222222222222222222222222222222222222222222222222222222222222222222222222222222222222222222222222222222222222222
22222222222222222222222222222222222222222222222222222222222222222222222222222222222222222222222222222222222222222222222222222222
22222222222222222222222222222222222222222222222222222222222222222222222222222222222222222222222222222222222222222222222222222222
22222222222222222222222222222222222222222200022222222222222222222222222222222222220002222222222222222222222222222222222222222222
22222222222222222222222222222222222220020044440222222222222222222222222222222222004444022002222222222222222222222222222222222222
22222222222222222222222222222220022224444422224402200222222222222222222222200200442222444442222002222222222222222222222222222222
22222222222222222222222222222224440224444422224444444222222222222222222222244444442222444442004442222222222222222222222222222222
22222222222222222222222222200204444444444444444444444222222222222222222222244444444444444444444442000222222222222222222222222222
22222222222222222222200222244444444444444444444444444402222222222222222220444444444444444444444444444222000222222222222222222222
22222222222222222222244402244444444444444444444444444442222222222222222224444444444444444444444444444200444222222222222222222222
22222222222222222222204444444444444444444444444444444442222222222222222224444444444444444444444444444444440222222222222222222222
22222222222222222222220444444444444444444444444444444444022222222222222044444444444444444444444444444444402222222222222222222222
22222222222222222222204422444444444444444444444444444444422222222222222444444444444444444444444444444422440222222222222222222222
02222222222222222222244422444444444444444444444444444444420002222200022444444444444444444444444444444422444222222222222222222200
44022222200222222002244444444444444444444444444444444444444444020044444444444444444444444444444444444444444220022222200222222044
44422222244402222444444444444444444444444444444444444444444444444444444444444444444444444444444444444444444444422200444222222444
44422222244444022444444444444444444444444444444444444444444444444444444444444444444444444444444444444444444444422044444222222444
44422222244444444444444444444444444444444444444444444444444444444444444444444444444444444444444444444444444444444444444222222444
44422222244004444400004444444444444444444444444444444444444444444444444444444444444444444444444444444444440000444440044222222444
44422222244444440022220044444444444444444444444444444444444444444444444444444444444444444444444444444444002222004444444222222444
44022222204444002222222200444444444444444444444444444444444444444444444444444444444444444444444444444400222222220044440222222044
00222222220000222222222222044444444444444444444444444444444444444444444444444444444444444444444444444022222222222200002222222200
22222222222222222222222222244444444444444444444444444444444444444444444444444444444444444444444444444222222222222222222222222222
22222222222222222222222222204444444444444444442244444444444444444444444444444444224444444444444444440222222222222222222222222222
22222222222222222222222222220444444444444444442244444444444444444444444444444444224444444444444444402222222222222222222222222222
22222222222222222222222222222444444444444444444444444444444444444444444444444444444444444444444444422222222222222222222222222222
22222222222222222222222222222444444444444444444444444444444444444444444444444444444444444444444444422222222222222222222222222222
22222222222222222222222222222444444444444444444444444444444444444444444444444444444444444444444444422222222222222222222222222222
22222222222222222222222222222444444444444444444444444444444444444444444444444444444444444444444444422222222222222222222222222222
22222222222222222222222222222444444444444444444444444444444444444444444444444444444444444444444444422222222222222222222222222222
22222222222222222222222222222444444444444444444444444444444444444444444444444444444444444444444444422222222222222222222222222222
22222222222222222222222222222422244444444444444444444444444444444444444444444444444444444444444222422222222222222222222222222222
22222222222220222222222222222022224444444444444444444444444444444444444444444444444444444444442222022222222222222202222222222222
22222222222200020222222222222222222244444444444444444444444222444422244444444444444444444444222222222222222222220000222222222222
22222222222000110222222222220022222222444444444444444444442222000022224444444444444444444422222222002222222222201100022222222222
22222222200000110222222222220022222222224444444444444444222222222222222244444444444444442222222222002222222222201100000222222222
22222220000000000022222222222222222222222244444444444422222222000022222222444444444444222222222222222222222222200000000002222222
22222000000000022222222222222222222222222222444444442222222222000022222222224444444422222222222222222222222222220000000000022222
22000000000000022222222222222222222222222222224444222222222222222222222222222244442222222222222222222222222222222000000000000222
00000000000000000222222222222222222222222222222222222222222222222222222222222222222222222222222222222222222222200000000000000000
00000000000000000022222222222222222222222222222222222222222222222222222222222222222222222222222222222222222222000000000000000000
00000000000000000002222222222222222222222222222222222222222222222222222222222222222222222222222222222222222220000000000000000000
00000000000000000000022222222222222222222222222222222222222222222222222222222222222222222222222222222222222000000000000000000000
00000000000000000000000222222222222222222222222222222222222222222222222222222222222222222222222222222222200000000000000000000000
00000000000000000000000002222222222222222222222222222222222222222222222222222222222222222222222222222220000000000000000000000000
00000000000000000000000000022222222222222222222222222222222222222222222222222222222222222222222222222000000000000000000000000000
00000000000000000000000000000222222222222222222222222222222222222222222222222222222222222222222222200000000000000000000000000000
00000000000000000000000000000002222222222222222222222222222222222222222222222222222222222222222220000000000000000000000000000000
00000000000000000000000000000000022222222222222222222222222222200222222222222222222222222222222000000000000000000000000000000000
00000000000000000000000000000000000222222222222222222222222220000002222222222222222222222222200000000000000000000000000000000000
00000000000000000000000000000000000002222222222222222222222000000000022222222222222222222220000000000200000000000000000000000000
00000000000000000000000002220000000000022222222222222222200000000000000222222222222222222000000000002220000000000000000000000000
00000000000000000000000002222200000000000222222222222220000000000000000002222222222222200000000000222220000000000000000000000000
00000000000000000000000002222222000000000002222222222000000000000000000000022222222220000000000022222220000000000000000000000000
00000000000000000000000002000222200000000000022222000000000000222200000000000222220000000000000222200200000000000000000000000000
00000000000000000000000002222222000000000000000000000000000022222222000000000000000000000000000022222220000000000000000000000000
00000000020000000000000000222220000000000000000000000000022222000022220000000000000000000000000002222200000000000000000000000000
00020000222200000000000000002220000000000000000000000000222200000000222200000000000000000000000002220000000000000000222200020000
00222222222222222200000000000200000000000000000000000022220000000000002222000000000000000000000000200000000000222222222222222200
22222222222222222220000000000000000000000000000000002222000000000000000022220000000000000000000000000000000002222222222222222222
22222222222222222200000000000000000000000000000000222200000000000000000000222200000000000000000000000000000002222222222222222222
22222222222222222220000000000000000000000000000022220000000000000000000000000222000000000000000000000000000002222222222222222222
22222222222222222000000000000000000000000000022220000000000000000000000000000022220000000000000000000000000000022222222222222222
22222222222222220000000000000000000000000002222200000000000000000000000000000000222200000000000000000000000000002222222222222222
22222222222222000000000000000000000000000022220000000000000000000000000000000000002222000000000000000000000000000222222222222222
22222222222200000000000000000000000000002222000000000000000000000000000000000000000022220000000000000000000000000000222222222222
22222222220000000000000000000000000000022200000000000000000000000000000000000000000000222000000000000000000000000000022222222222
22222222222220000000000000000000000000022000000000000000000000000000000000000000000000020000000000000000000000000002222222222222
22222222222222000000000000000000000000022000000000000002220000222200000000000000000000022000000000000000000000000222222222222222
22222222222222220000000000000000000000000000000000000000222222220222222200000000000000022000000000000000000000002222222222222222
22222222222222222200000000000000000000222000000000000022222222200022222222000000000000022200000000000000000000222222222222222222
22222222222222222220000000000000000002220000000000000220000200000000200022200000000000002220000000000000000002222222222222222222
22222222222222222220000000000000000000200000000000000220000000000000000002200000000000000220000000000000000002222222222222222222
22222222222222222222000000000000000022200000000000000220000000000000000002222000000000000222000000000000000022222222222222222222
22222222222222222222220000000000002222000000000000000020000000000000000002222000000000000022220000000000002222222222222222222222
22222222222222222222222200000000022200000000000000002220000000000000000002220000000000000000222000000002222222222222222222222222
22222222222222222222222222222200002000000000000000022220000000000000000002222000000000000000022002222222222222222222222222222222
22222222222222222222222222222222222000000000000000002220000000000000000002200000000000000000022222222222222222222222222222222222
22222222222222222222222222222222220000000000000000000220000000000000000000200000000000000000002222222222222222222222222222222222
22222222222222222222222222222222000000000000000000000222000000000000000022200000000000000000000222222222222222222222222222222222
22222222222222222222222222222222220000000000000000000022200000000000000222000000000000000000002222222222222222222222222222222222
22222222222222222222222222222222222000000000000000000222200000000000000222200000000000000000022222222222222222222222222222222222
22222222222222222222222222222222222000000000000000000022200000000000000222000000000000000000022222222222222222222222222222222222
22222222222222222222222222222222222000000000000000002222200000000000000220000000000000000000022222222222222222222222222222222222
22222222222222222222222222222222222000000000000000022222222222222222222222200000000000000000002222222222222222222222222222222222
22222222222222222222222222222222222200000000000000000000022222222222222222200000000000000000222222222222222222222222222222222222
22222222222222222222222222222222222220000000000000000000000000000000000000000000000000000002222222222222222222222222222222222222
22222222222222222222222222222222222200000000000000000000000000000000000000000000000000000000022222222222222222222222222222222222
22222222222222222222222222222222222000000000000000000000000000000000000000000000000000000000022222222222222222222222222222222222
22222222222222222222222222222222222000000000000000000000000000000000000000000000000000000000022222222222222222222222222222222222
22222222222222222222222222222222220000000000000000000000000000000000000000000000000000000000002222222222222222222222222222222222
22222222222222222222222222222222000000000000000000000000000000000000000000000000000000000000000222222222222222222222222222222222
22222222222222222222222222222222220000000000000000000000000000000000000000000000000000000000002222222222222222222222222222222222
22222222222222222222222222222222222000000000000000000000000000000000000000000000000000000000222222222222222222222222222222222222
22222222222222222222222222222222220000000000000000000000000000000000000000000000000000000002222222222222222222222222222222222222
