1111111111111111111111111111111111111111111111111111111111111111111111111111111111111111111111111111111111111111111111111111111111111111111111111111
1111111111111111111100000011111111111111111111111111111111111111111111000011111111111111111111111111111111111111111111111111110000001111111111111111
1111111111111111111000000001111111111111111111111111111111111111111110000001111111111111111111111111111111111111111111111111100000000111111111111111
1111111111111111110000000000001111111111111111111111111111111111111100022200000011111111111111111111111111111111111111111100000000000000001111111111
1111111111111000000000022200000111111111111111111111111111111111111000022200220001111111111111111111111111111111111001111000000000000000000111111111
1111111111111000000220022200000011111111111111111111111111111111000000022202202200011111111111111111111111111111000000000000000000000000000011111111
1111111111111000022022022200000001111111111111111111111111111110002220000000000220011111111111111111111111111110000000000000000000000000000001111111
1111111111110000220000000000222001111111111111000000111111111110002220000000000022011111111111111111111111111100000000000000000000002200000000111111
1111111111100002200000000000222000111111111110000000011111111111002220000000000000011111111111111111111111111000000000000000000000022022000000011111
1111111111100000000000000000222000111111111000000000001111111111000000000000000022001100001111111111111111110000000000000000000000000000022000001111
1111111111100002200000000000000000111111110000000000000111111111000000000000000002201000000111111111111111100000000000000000000000000000002200000111
1111111111100022000000000000000000111111100000000000000111111111000000000000000022011000000000111111111111100000000000000000000000000000000000000111
1111111111100002200000000000000000011110000000000000000011111111000000000000000000111200000000011111111111110000000000000000000000000000002200000111
1111111111100000000000000000000000001110000000000000000000111110000000000000000000222200000000011111000000111000000000000000000000000000000220000111
1111111111100000000000000000000000000110000000000000000000000000000000000000000000222200000000011110000000111100000000000000000000000000002200000111
1111111111100000000000000000000000000011000000000000000000000000000000000000000000222200000000000000000000011110000000000000000000000000000000000011
1111111111200000000000000000110000000001000000000000000000000000000000000000000000222200000000000000000000022111000000000000000000000000000000000001
1111111112220000000000000001111000000000000000000000000000000000000000000000000000222200000000000000000000220221100000000000000000000000000000000001
1111111122222000000000000011111100000000000000000020000000000000000000000000000000222200000000000000000000000022110000000000000000000000000000000001
1111002222222200000000000011111110000000000000000022000000000000000000000000000000222200000000000000000000000002211000000000000000000000000000000001
1110002222222220000000000001111111000000000000000220000000000000000011000000000000222200000000000000000000000000011000000000000000000000000000000011
1100000222222222000000000000111111100000000000112200000000000000001111111111111111111200000000000000000000000002211000000000000000000000000000000111
1000000022222222200000000000011111100000000001111200000000000000011111111111111111111000000000000000000000000000221000000000000000000000000000000111
1000000002222222220000000000001111000000001111111000000000000000011111111111111111111000000000000000000000000002201000000000000000000000000000000111
1000000000222222211111000000000110000000001111111000000000000002111111111111111111111100111000000000000000000000001100000000000000000000000000001111
1000000000022222111111100000000000000000001111111000000000000022211111000000000011111111111100000000000000000000000110000000000000000000000000011111
1000000000002221111111110000000000000000000111111000000000000222221110000000000001111111111100000000000000000000000011000000000000000000000000011111
1000000000000221111111111000000000000000000011111000000000002222222100000000000000111111111000000000000000000000000001100000000000000000000000001111
1000000000000011111111111100000000000000000011110000000000022222222200002222000000011111100000000000000000000000000000110000000000000000000000000111
1000000000000011111111111110000000000000000000000000000000222222222002222002222000001111100000000000000000000000000000111111100000000000000000000111
1100000000000011111111111000000000000000000000000000000000122222220000000000002200000111100000000000000000000000000000111111110000000000000000000111
1110000000000001111111111100000000000000000000000000000000112222200000000000000220000000000000000000000000000000000001111111111000000000000000000111
1110000000000000011111111120000000000000000000000000000001111222000000000000000000000000000000000000000000000000000001111111111220000000000000000111
1110000000000000001111111222000000000000000000000000000001111220000000000000000000000000000000000000000000000000000001111111111222000000000000000111
1110000000000000000111112222200000000000000000000000000001111000000000000000000000000000000000000000000000000000000001111111112222000000000000001111
1110000000000000000000222222220000000000000000000000000011111000000000000000000000000000000000000000000000000000000000111000122211100000000000011111
1110000000000000000000222222222000000000000011100000000011111000000000000000000000000000000000000000000000000000000000011000222111110000000000111111
1100000000000000000000022222222201111000000111111000000111111000000000000000000000000000000000011110000000000000000000000000021111111111100001111111
1000002200000000000000002222222111111000000111111000000111111000000000000000000000000000000000011111000000000000000000000000000000000000110011111111
1000022000000000000000000222221111111000000111111000000111111000000000000000000000000000000000011111111110000000000000000000000022000000011111111111
1000000000000000000000000022211111111000000111111000000111111100000000000000000000000000000000111111111112200000000000000000000220022000000111111111
1000022000000000000000000002211111111000000111111000000111111110000000000000000000000000000001111111111112220000000000000000000000002200000111111111
1000220000000000000000000000011111111000000111111000000111111112200000000000000000000000000011111111111122222000000000000000000000000220000111111111
1000000000000000000000000000011111000000000001110000000001111111120000000000000000000000011111111111111222222200000000000000000000000000000011111111
1000220000000000000000000000111111000000000000000000000000111111122000000000000000000002211111111111002222222220000000000000000000000220000001111111
1000022000000000000000000001111111000000000000000000000000011111122200000000000000000022211111111000000222222222000000000000000000000022000001111111
1000000000000000000000000221111111000000000000000000000000002111122220000000000000000222221111110000000022222222111100000000000000000220000001111111
1000022000000000000000002221111110000000000000000000000000000222112222000000000000002222222110000000000002222211111100000000000000000000000001111111
1100002200000000000000022222111100000000000000000000000000000022211222000000000000022222222200000000000000222111111100000000000000000000000001111111
1110000000000000000000222222211100000000000000000000000000000002221111100000000000222222222000000000000000021111111100000000000000000000000001111111
1110000000000000000002222222220000000000000111110000000000000000222111110011100000222222220000000000000000001111111000000000000000000000000001111111
1110000000000000000022222222200000000000001111110000000000000000021111111111110001112222200000000000000000001111111000000000000000000000000001111111
1111000000000000000022222222000000000000011111110000000000000000000111111111110011111222000000000000000000001111111100000000000000000000000011111111
1111100000000000000111222220000000000000011111110000000000000000000011111111111111111120000000000000000000001111111111100000000000000000000111111111
1111110000000000001111122200000000000000001111110000000000000000000011111111111111111000000000000000000000000011111111110000000000000000000111111111
1111111110000001111111112000000000000000001111100000000000000000000001111111111111110000000000000000000000200222011111111000000000000000000111111111
1111111111000011111111111000000000000000000000000000000000000000000000111111111110000000000000000000000000000222002111111100000000000000001111111111
1111111111111111111111111100000000000000000000000000000000000000000000011111111100000000000000000000000000000222022022111110000000000000011111111111
1111111111111111111111111100000000000000000000000000000000000220000000000020000000000000000000000000000000000000000002211110000000000000111111111111
1111111111111111111111111100000000000000000000000000000000002200000000000022000000000000000000000000000000000000000000221110000000000001111111111111
1111111111111111111111111102220000000000000000000000000000022000000000000220000000000000000000000000000000000000000000001111000000000011111111111111
1111111111111111111111111112220000000000000000000000000000220000000000002200000000000000000111110000000000000000000000221111111000011111111111111111
1111111111111111111111111112220000000000000000000000011111120000000000002000000000000000011111110000000000000000000000022111111100111111111111111111
1111111111111111111111111110000000000000000000000000111111110000000000002000000000000000111111110000000000000000000000220111111111111111111111111111
1111111111111111111111111110220000000000000000000000111111110000000000000002000000000000111111110000000000000000000000000111111111111111111111111111
1111111111111111110011111112200000000000000000000000111111100000000000000002000000000000211111100000000000000000000000222111111111111111111111111111
1111111111111111100001111111220000000000000000000000111110000000000000000022000000000000220000000000000000000000000000222111111111111111111111111111
1111111111111100000000001111000000000000000000000000000000000000000000000220000000000002200000000000000000000000000000222011111111111111111111111111
1111111111111000000000000111220000000000000000000000000000000000000000002200000000000022000000000000000000000000000000000011111111111111111111111111
1111111111110000000000000111122000000000000000000000000000000000000000000200000000000220000000000000000000000000000000000011111111111111111111111111
1111111111100000000000000111112202202220000000000000000000000000000011111111100000000000000000000000000000000000000000000011111111111111111111111111
1111111111000000000000000011111122002220000000000000000000000000000111111111110000000000000000000000000000000000000000000001111111111100001111111111
1111111110000000000000000001111111102220000000000000000000000000111111111111111000000000000000000000011111000000000000000002111111111000000111111111
1111111110000000000000000000111111111100000000000000000000000001111111111111111100000000000000000000111111000000000000000022211111000000000000111111
1111111110000000000000000000011111111111000000000000000000000211111111111111111100000000000000000000111111100000000000000222221110000000000000011111
1111111100000000000000000000000011111111000000000000000000002221111100111111111110000000000000000000111111100000000000002222222110000000000000001111
1111111000000000000000000000000001111111000000000000000000022222111000111111111111200000000000000000111111000000000000022222222200000000000000000111
1111111000000000000000000000000001111111000000000000000000222222220000011100111112220000000000000000111110000000000000222222222000000000000000000111
1111111000000000000000000000000011111111200000000000000002222222220000000000011111222000000000000000000000000000000011122222220000000000000000000111
1111111000000000000000000000000011111112220000000000000022222222200000000000002221122200000000000000000000000000000011112222200000000000000022000011
1111111000000000000000000000000011111122222000000000000112222222000000000000002222112220000000000000000000000000000111111222000000000000000002200001
1111111000000220000000000000000011112222222200000000111111222220000000000000000222211112000000000000000000000000001111111220000000000000000000000001
1111111000002200000000000000000000002222222220000001111111122200000000000000000022211111100000000000000000000000001111111000000000000000000002200001
1111111000000220000000000000000000000222222222001111111111122000000000000000000002211111110000000000000000000000001111110000000000000000000000220001
1111111100000000000000000000000000000022222221111111111111100000000000000000000000211111111000000000111000000000001111100000000000000000000000000001
1111111110000220000000000000000000000002222211111111111100000000000000000000000000022111111110000001111110000001111111100000000000000000000000220001
1111111110000022000000000000000000000000222111111111111000000000000000000000000000000111111110000001111110000001111111122000000000000000000002200001
1111111110000002200220000000000000000000022111111111110000000000000000000000000000000011111110000001111110000001111111122200000000000000000000000001
1111111111100000002200000000000000000000000111111111100000000000000000000000000000000001111110000001111110000001111111222220000000000000000002200001
1111111100110000000000000000000000000000000000001111100000000000000000000000000000000001111110000001111110000001111112222222000000000000000022000001
1111111000011111111111200000000000000000000000000111100000000000000000000000000000000001111110000001111110000001111022222222200000000000000000000011
1111110000000000111112220001100000000000000000000000000000000000000000000000000000000001111100000000011100000000000002222222220000000000000000000111
1111100000000000011122210001110000000000000000000000000000000000000000000000000000000001111100000000000000000000000000222222220000000000000000000111
1111000000000000002222111111111000000000000000000000000000000000000000000000000000000001111000000000000000000000000000022222111110000000000000000111
1110000000000000002221111111111000000000000000000000000000000000000000000000000000000221111000000000000000000000000000002221111111000000000000000111
1110000000000000000221111111111000000000000000000000000000000000000000000000000000002221111000000000000000000000000000000211111111100000000000000111
1110000000000000000001111111111000000000000000000000000000000000000220000000000000022222110000000000000000000000000000000011111111111000000000000111
1110000000000000000000111111110000000000000000000000000000011110000022000000000000222222210000000000000000000000000000000001111111111100000000000011
1110000000000000000000011111110000000000000000000000000000011111000002222002222002222222220000000000000000000000000000000111111111111100000000000001
1110000000000000000000000000110000000000000000000000000000011111100000002222000022222222200000000000111100000000000000000011111111111100000000000001
1111000000000000000000000000011000000000000000000000000001111111110000000000000012222222000000000001111100000000000000000001111111111220000000000001
1111100000000000000000000000001100000000000000000000000011111111111000000000000111222220000000000001111110000000000000000000111111111222000000000001
1111100000000000000000000000000110000000000000000000000011111111111100000000001111122200000000000001111111000000000000000000011111112222200000000001
1111000000000000000000000000000011000000000000000000000001110011111111111111111111112000000000000001111111000000000110000000001111122222220000000001
1110000000000000000000000000000001022000000000000000000000000001111111111111111111100000000000000001111111000000001111000000000000222222222000000001
1110000000000000000000000000000001220000000000000000000000000001111111111111111111100000000000000021111000000000011111100000000000022222222200000001
1110000000000000000000000000000001122000000000000000000000000021111111111111111111000000000000000022110000000000011111110000000000002222222220000011
1100000000000000000000000000000001100000000000000000000000000022220000000000001100000000000000000220000000000000001111111000000000000222222222000111
1000000000000000000000000000000001122000000000000000000000000022220000000000000000000000000000002200000000000000000111111100000000000022222222001111
1000000000000000000000000000000000112200000000000000000000000022220000000000000000000000000000000200000000000000000011111100000000000002222211111111
1000000000000000000000000000000000011220220000000000000000000022220000000000000000000000000000000000000000000000000001111000000000000000222111111111
1000000000000000000000000000000000001112200000000000000000000022220000000000000000000000000000000000000000001000000000110000000000000000021111111111
1100000000000000000000000000000000000111100000000000000000000022220000000000000000000000000000000000000000001100000000000000000000000000011111111111
1110000022000000000000000000000000000011110000000111100000000022220000000000000000000000000000000000000000000110000000000000000000000000011111111111
1110000220000000000000000000000000000001110000001111100000000022220000000000000000000111110000000000000000000111000000000000000000000000011111111111
1110000022000000000000000000000000000000111111111111100000000021110000000000000000001111111100000000000000000111100000000000000000022000011111111111
1110000000000000000000000000000000000000011111111111110000000001102200000000000000001111111110000000000000011111110000000000000000002200011111111111
1110000022000000000000000000000000000000011111111111111110000001022000000000000000001111111110000000000000111111110000000000000000022000011111111111
1111000002200000000000000000000000000000111111111111111111000011002200000000000000001111111111000000000001111111110002220000000000000000011111111111
1111100000002202200000000000000000000001111111111111111111111111100000000000000222001111111111100000000111111111110002220000000000022000011111111111
1111110000000022000000000000000000000011111111111111111111111111102200000000000222000111111111110000001111111111111002220000000000220000111111111111
1111111000000000000000000000000000000111111111111111111111111111100220000000000222000111111111111111111111111111111000000022202202200001111111111111
1111111100000000000000000000000000001111111111111111111111111111100022022022200000001111111111111111111111111111111100000022200220000001111111111111
1111111110000000000000000001111001111111111111111111111111111111111000220022200001111111111111111111111111111111111110000022200000000001111111111111
1111111111000000000000000011111111111111111111111111111111111111111100000022200011111111111111111111111111111111111111000000000000111111111111111111
1111111111111110000000011111111111111111111111111111111111111111111111111000000111111111111111111111111111111111111111111000000001111111111111111111
1111111111111111000000111111111111111111111111111111111111111111111111111100001111111111111111111111111111111111111111111100000011111111111111111111
1111111111111111111111111111111111111111111111111111111111111111111111111111111111111111111111111111111111111111111111111111111111111111111111111111
