111111111111111111111111111111111111111111111111111111111111111111111111111111111111111111111111111111111111111111111111111111111111
111111111111111111111111111111111111111111111100001111110011111111111111111111111111111111111111111111111100111111000011111100111111
111111111111111111111111111111111111111111111000000111100001111111111111111111111111111111111111111111111000011110000001111000011111
111111111111111111111111111111111111111111000000000000000000001111111111111111111111111111111111111111000000000000000000000000001111
111111111111111111111111111111111111111110000000000000000000000111111111111111111111111111111111111110000000000000000000000000000111
111111111111111111111111111111000000011110000000002202200000000111111111111111111111111111111111111110000000000000000000000000000011
111111111111111111111111111100000000001110000022022000220220000111111111111111111111111111111111111110000000000022200000000000000001
111111111111111111111111000000000000001000000220000000000022000000111111111111111100000000011111111100000000000022200220000000000001
111111111111111111111110000000000000001000000000000000000000000000011111111111100000000000001111111000000000000022202202200000000001
111111111111111111111111000000000000001000000000000000000022200000011111111100000000000000000111110000000000000000000000002200000001
111111111111111111111111000000000000111200000000000000000022200000111111111000000000000000000111100000000000000000000000000220000001
111111111111111111111110000000000000222200000000000000000022200001111111111000000022200000000111100000000000000000000000000000000001
111111111111111111111100000000000000222200000000000000000000000001111111111000000022200220000111100000000000000000000000000220000011
111111111111001111111111100000000000222200000000000000000022200000111111110000000022202202201111100000000000000000000000000022000111
111111111110000111111111120000000000222200000000000000000022200000011111110000000000000000002211110000000000000000000000000220000111
111111111100000011111111222020000000222200000000000000000022200000011111100000000000000000000221111000000000000000000000000000000111
111111111000000001111112222222200000222200000000000000000000000000111111110000000000000000000001111000000000000000000000000222000111
111111110000000000001110222222220000222200000000000000000000000001111111111000000000000000000221111000000000000000000000000222000011
111111100000000000000110202222222200222200000000000000000000000011111111111000000000000000000022111100000000000000000000000222000001
111111000000000000000000000022222111111200000000000000000000000111111111110000000000000000000221111110000000000000000000000000000001
111110000002202200000000000002221111111100000000000000000000022111111111111000000000000000000000111010000000000000000000000000000001
111100000022000220000000000000211111111100000000000000000000222111111111111100000000000000000222101010000000000000000000000000000001
111110000220000000000000000000011111111110000000000000000002222211111111111100000000000000000222111110000000000000000000000000000011
111110000000000000000000000000001111111111000000000000000022222221111111111000000000000000000222011100000000000000000000000000000111
111110002200000000000000000000001111111111222220200000000222222222000011110000000000000000000000011000000000000000000000000000001111
111100022000000000000000000000000111111110222222222200002222222220000001100000000000000000000000111000000000000111111111111000011111
111100002200000000000000000000021111111100002022222111102222222200000000000000000000000000000001111100000000022111000000001100111111
111100000000000000000000000000222111110000000000221111111122222000000000000000000000000000000001111110000000222111000000000111101111
111100022200000000000000000002222211110000000000001111111112220000000000000000000000000000000211111111000000222211000000000000000111
111100022200000000000000000022222222000000000000001111111111200000000000000000000110000000002221111111100001112221000222000000000111
111100022200000000000000000222222222000000000000001111111111000000000000000000001111000000022222111111110011111222000222000000000111
111110000000000000000000002222222220000000000000000111111111000000000000000000011111100000222222220001111111111120000222000000000111
111110000000000000000000001222222200000000000000000011111110000000000000000000011111110000122222220000011110000000000000022000000111
111110000022200000000000001122222000000000000000000000111110000000000000000000011111111111112222200000000000000000000000002200000011
111110000022200000000000001112220000000000000000000000011110000000000000000000011111111111111222000000000000000000000000000000000011
111110000022200000000000001112200000000000000000000000011111000000000000000000011111111111111220000000000000000000000000002200000011
111111000000000000000000011110000000000000000000000000011111000000000000000000011111111111111000000000000000000000000000000220000011
111111111000000000000000111110000000000000000000000000001111100000000000000000011111111111110000000000000000000000000000000000000001
111111111100000000000000111110000000000000000000000000001111112000000000000002111111111111110000000000000000000000000000000220000001
111111111111100000000001111100000000000000000000000000011111122200000000000022211111001111110000000000000000000000000000002200000001
111111111111100000000001111100000000000000000000000001111111222220000000000222221110001111110000000000000000000000000000000000000011
111111111111000000000011111110000000000000000000000011111122222222000000002222222200000111100000000000000000000000000000002200000111
111111111110000000000001111111000000000000000000000011111022222222200000022222222200000000000000000000000000000000000000022000000111
111111111110000000000001111111111000000000000000000221110002222222220000222222222000000000000000000000011110000000000222000000001111
111111111111000000000000111111111220000000000000002222200000222222210000122222220000000000000000000000011110000000000222000000001111
111111111111100000000000111111111222000000000000022222000000022222111001112222200000000000000000000000111111000000000222000000001111
111111111111100000000000111111112222200000000000222220000000002221111111111222000000000000000000000001111111000000000000000000001111
111111111111000000000000011000122222220000000000222200000000000221111111111220000000000000000000000001111111000000000000000000011111
111111111110000000000000000000222111122000000022222000000000000001111111111000000000000000000000000011111111000000000000000000111111
111111111100000000000000000000021111112200000002202000000000000000111111111000000000000000000000000001111111100000000000000000111111
111111111000000000000000000000001111112200000000220000000000000000011111111000000000000000000000000221111111110000000000101111111111
111111110000000000000000000000000111111110000111100000000000000000011111110000000000000000000000002221111111111110000001111111111111
111111110000000000000000000000000011111111001111100000000000000002211111100000000000000000000000022222111111111111000011111111111111
111111110022200000000000000000000001111111111111000000000000000022211111100000000000000000000000222222211111111111111111111111111111
111111110022200000000000000000000000011111111110000000000000000222211111110000000000000000000002222222220000022211110111111111111111
111111110022200000000000000000000000001111111100000000000000002222111111111000000000000000000022222222200000022211220111111111111111
111111100000000000000000000000000000001111111110000000000000022222111111111000000000000000000022222222000000022202200221111111111111
111111100002200000000000000000000000011111111111000000000000222222111111111000000000000000000111222220000000000000000021111111111111
111111100022000000000000000000000000011111111111000000000002222222111111111000000000011111001111122200000000000000000002200111111111
111111100002200000000000000000000001111111111111000000000022222222211112220000000000111111111111112000000000000000000000000011111111
111111110000000000000000000000000211111111111111000000000022211112222222220000000000111111111111100000000000000000000002200001111111
111111111002200000000000000000002221111100111110000000000111111111222222200000000000111111111110000000000000000000000000220001111111
111111111111120000000000000000022222111000000000000000000111111111222222000000000000111111111110000000000000000000000002200001111111
111111111111122002202220000000222222220000000000000000000111111111222220000000000000011111111100000000000000000000000000000001111111
111111111111111022112220000002222222220000000000000000000111111111222200000000000000001111111100000000000000000000000002220011111111
111111111111111011112220000022222222200000000000000000000011111112222000000000000000011111111110000000000000000000000002220011111111
111111111111111111111111111112222222000000000000000000000001111112220000000000000000111111111111100000000000000000000002220011111111
111111111111110000111111111111222220000000000000000000000001111112200000000000000001111100111111110000000000000000000000000011111111
111111111111100000011111111111122200000000000000000000000011111110000000000000000001111000011111111000000000000000000000000011111111
111111111101000000000011111111122000000000000000000000000111111110000000000000000022000000002211111100000000000000000000000111111111
111111000000000000000001111111100000000000000000000000000111111111000000000000000202200000002211111120000000000000000000001111111111
111111000000000000000000111111110000000000000000000000000111111111100000000000000222220000000221111222000000000000000000011111111111
111110000000000000000000111111100000000000000000000000022111111111122000000000002222000000000022222221000110000000000000111111111111
111100000000000000000000111111100000000000000000000000222111111111122200000000022222000000000002222211111111000000000001111111111111
111100000000222000000000111111000000000000000000000002222211100111222220000000222220000000000000222111111111000000000001111111111111
111100000000222000000000011110000000000000000000000022222221000012222222000002222200000000000000022111111111000000000000111111111111
111100000000222000000000011110000000000000000000000222222222000022222222200011122000000000000000000111111111100000000000011111111111
111000000220000000000000000000000000000000000000002222222220000002222222220111110000000000000000000000111111100000000000011111111111
111000002200000000000000000000000000000001111000002222222200000000222222221111110000000000000000000000011111110000000000111111111111
110000000000000000000000000000000000000011111100011122222000000000022222111111100000000000000000000000001111100000000001111111111111
100000002200000000000000000000000000000011111100111112220000000000002221111110000000000000000000000000001111100000000001111111111111
100000022000000000000000000000000000000011111111111111200000000000000211111100000000000000000000000000011111000000000000001111111111
100000000000000000000000000000000000000011111111111110000000000000000001111100000000000000000000000000011111000000000000000111111111
110000022000000000000000000000000000000111111111111110000000000000000000111110000000000000000000000000011110000000000000000000111111
110000002200000000000000000000000000022111111111111110000000000000000000111110000000000000000000000002211100000000000002220000011111
110000000000000000000000000000000000222111111111111110000000000000000000011110000000000000000000000022211100000000000002220000011111
110000002200000000000000000000000002222211111111111110000000000000000000011111000000000000000000000222221100000000000002220000011111
111000000220000000000000011110000022222221000011111110000000000000000000011111110000000000000000002222222100000000000000000000011111
111000000000222000021111111111100022222222000001111110000000000000000000111111111000000000000000022222222200000000000000000000011111
111000000000222000222111110011111111222220000000111100000000000000000000111111111100000000000000222222222000000000000000002220001111
111000000000222000122211100001111111122200000000011000000000000000000002111111111100000000000000222222220000000000000000002220001111
111000000000000000112222000000111111112000000000000000000000000000000022211111111100000000000011112222200000000000000000002220001111
111101111000000000111222000000011111100000000000000000000000000000000222221111111122000000000011111222000000000000000000000000001111
111111001100000000111220000000001111100000000000000000000000000000002222222201111222220200001111111120000000000000000000002200001111
111110000111111111111000000000000111000000000000000000000001100000022222222200002222222222011111111000000000000000000000000220001111
111100000000000000000000000000000110000000000000000000000011110000222222222000000002022222111111111100000000000000000000002200011111
111000000000000000000000000000001110222000000000000000000111111111122222220000000000000000111111111100000000000000000000000000011111
110000000000000000000000000000011111222000000000000000001111111111112222200000000000000000011111111110000000000000000000022000011111
100000000000000000000000000000010101222000000000000000001111111111111222000000000000000000001111111112000000000000022000220000001111
100000000000000000000000000000010111000000000000000000000111111111111220000000000000000000001111111122200000000000002202200000011111
100000000000000000000000000000011111122000000000000000000011111111111000000000000000000000002111111222220000000000000000000000111111
100000222000000000000000000000001111220000000000000000000111111111110000000000000000000000002222002222222202011000000000000001111111
110000222000000000000000000000000111122000000000000000000111111111100000000000000000000000002222000022222222011100000000000011111111
111000222000000000000000000000000111100000000000000000000011111111000000000000000000000000002222000002222222211111100000000111111111
111000000000000000000000000000000111122000000000000000000001111110000002220000000000000000002222000000020222111111110000001111111111
111000022000000000000000000000000011112200000000000000000011111110000002220000000000000000002222000000000021111111111000011111111111
111000220000000000000000000000000001111102202202220000000011111111000002220000000000000000002222000000000001111111111100111111111111
110000022000000000000000000000000001111000022002220000000111111111100000000000000000000000002222000000000000001111111111111111111111
100000000000000000000000000000000001111000000002220000000111111111100002220000000000000000002222000000000000011111111111111111111111
100000022000000000000000000000000001111000000000000000000111111111000002220000000000000000002111000000000000111111111111111111111111
100000002200000000000000000000000011111000000000000000001111111110000002220000000000000000000100000000000000111111111111111111111111
100000000002202202220000000000000111111100000000000001111111111110000000000000000000000000000100000000000000011111111111111111111111
100000000000022002220000000000001111111110000000001111111111111111000000220000000000022000001100000000000000111111111111111111111111
100000000000000002220000000000011111111111111111111111111111111111111000022022000220220000011100000000001111111111111111111111111111
110000000000000000000000000000011111111111111111111111111111111111111000000002202200000000011110000000111111111111111111111111111111
111000000000000000000000000000011111111111111111111111111111111111111000000000000000000000011111111111111111111111111111111111111111
111100000000000000000000000000111111111111111111111111111111111111111100000000000000000000111111111111111111111111111111111111111111
111110000111100000011110000111111111111111111111111111111111111111111111100001111000000111111111111111111111111111111111111111111111
111111001111110000111111001111111111111111111111111111111111111111111111110011111100001111111111111111111111111111111111111111111111
111111111111111111111111111111111111111111111111111111111111111111111111111111111111111111111111111111111111111111111111111111111111
