11111111111111111111111112000000000000000000000000000000000000111111110000111111000000000000001111111200000000000000000000000000
11111111112222221111111112000000000000000011002222000222200011111111000011111100000000000000000011111200000000000000000000000000
11111111112222222211111112000000000000000000002222022000220011111111000011111100000000002200000021111100000000000000000000000000
11111111222222222222111111002111000000000000000000000000022011111111000000111111000000000000000011111200000000000000000000000000
11111111222222221111111211002111111112000000000000000000000000111111000000111111000000000022001111111200000000000000022220000000
11111111111111111111111100001111111112000000000000000000002211111111000011111100000000000220211111110000000000000000022220000000
11111111111111111111111111111111111111000000000000000000022011111100001111110000000000000022211111000000000000000000000000002200
11111111111111112200111111111111111112000000000000000000022011111100001111110000000000000000211111120000000000000000000000002200
11111111110222200000001111111111111112000000000000000000000011110000001111110000000000000022001111120000000000000000000000000220
11111111000222200000002111111111111100000000000000000000000011110000111111000000000000000022002111110000000000000000000000000220
11111100000000000000002111111111111112000000000000000000000000000011111100000000000000000220002111111200000000000000000000000000
11111112000000000000000011111111111112000000000000000000000000001111111100000000000000000000000011111200000000000000000000000220
11111112022000000000000000111111111112000000000000000000000000001111111100000000000000000000002111111200000000000000000000002200
11111112220000000000000000001111111100000000000000000000000000000011111100000000000000000000002111110000000000000000000000000220
11111100022000000000000000000011111200000000000000000000000000000011111100000000000000000000002111111200000000000000000000002200
11111200220000000000000000000021111100000000000000000000000000021111111100000000000000000000000011111200000000000000000000220000
21111100220000000000000000000021111200000000000000000000000000222111111111000000000000000000002111111200000000000000000000000000
11111111022000000000000000000000111200000000000000000000000222222221111111000000000000000000002111110000000000000000000000000000
11111111120000000000000000000000000000000000000000000000222222222222211100000000000000000000001111120000000000000000000000000000
11111111122200000000000000000000000000000000000000000000111222222222220000000000000000000000111111120000000000000000000000000000
11111111120000000000002111000000000000000000000000000011111112222222000000000000000000000021111111000000000000000000000000000000
11111111111100000000002111120000000000000000000000001111111111122200000000000000000000000021111100000000000000000000000000000000
11111111111112000000001111120000000000000000000000001111111111120000000000000000000000211111111200001121110000000000000000000000
11111111111112000000002111110000000000000000000000000011111111200000000000000000000000211111111100001121111200000000000000000000
11111111111112000000001111120000000000000000000000000000111111000000000000000000000000111111111111111111111200000000000000000000
11111111000000000000002111110000000000000000000000000000001111110000000000000022000011111111111111111111111111120000000000000000
11111100000000000000002111111200000000000000000011000000000011111100000000000000002111111111111111111111111111120000000000000000
12000000000021111111000011111200000000000000000000000000000000111111000000000000002111111111111111111111111111110000000000000000
12000000000021111111111111111200000000000000000000001100000000111111000000000000002111111111111111111111111111111100000000000000
00000000000021111111111111110000000000002200000000000000000011111100000000000000001111111111111111111111111111111112000000000000
00000000000000111111111111111200000000000000000000000000000011111100000000000000002111112211111111111111110000111112000000000000
00000000000000000000111111111200000000110000000000000000000000111111000000000000002111222222111100000000000000211111000000000000
00000000000000000000000021111100000000110000000000000000000000111111000000000000001111222222111200000022220220211111120000000000
00000000000000000000000011111211000000000000000000000000000011111100000000000000211122222222111100002202200002201111120000000000
00000000000000000000000021111111000000000000000000000000000011111100000000000000211122222222111200000000000000220011120000000000
00000000000000000000000021111112000000000000000000000000000011111100000000000000111122222211111222220000000000000000000000000000
00000000000000000000000000111112000000000000000000000000001111110000000000000000211122222211110022220000000000000000000000000000
00000000000000000000000000211111000000000000000000000000001111110000000000000000111122222211120000000000000000000000211100000000
00000000000000000000000000211111110000000000000000000000111111110000000000000000211111221111120000000000000000000000211111111111
00000002222000000000000000001111111200000000000000000000111111000000000000000000211111111111000000000000000000000000111111111111
00000002222000000000000000000011111200000000000000000011111100000000000000000000001111111111120000000000000000211111111111111111
00220000000000000000000000002111111200000000000000000011111100000000000000000000002111111111120000000000000000211111111111111111
02200000000000000000000000002111110000000000000000000011111100000000000000000000001111111111110000000000000000211111111112000011
00000000000000000000000000001111120000000000000000001111110000000000000000000000211111111111111111110000000000001111111112000011
02200000000000000000000000002111110000000000000000001111110000000000000000000000211111111111111111111100000000000000001112000000
02200000000000000000000000002111111200000000000000000011111100000000000000000000211111111111111111111111000000000000000000000000
00220000000000000000000000000011111200000000000000000000111111000000001100000000001111111111111111111111120000000000000000000000
02200000000000000000000000002111111200000000000000000000111111000000000000000000000011111111111111111111120000000000000000000000
00220000000000000000000000002111110000000000000000000000111111000000000000000000000000002111111111111111120000000000000000000000
00000000000000000000000000001111120000000000000000000000001111110000000000000000000000001111111111111200000000000000000000000000
00022220000000000000000000211111120000000000000000000000001111110000000000000000000000002111111111111200000000000000000000000000
00000000000000000000000000211111000000000000000000000000111111000000000000000000000000002111111100000000000000000000000000000000
00000000000000000000000000211111120000000000000000000011111111000000000000000000000000000000000000000000000000000000000000000000
00000000000000000000000000001111120000000000000000000011111111000000000000000000000000000000000000000000000000000000000000000000
00000000000000000000000000211111120000000000000000000011111100000000000000000000000000000000000000000000000000000000000000000000
00000000000000000000000000211111000000000000000000001111110000000000000000000000000000000000000000000000000000000000000000000000
00000000000000000000000000111112000000000000000000001111110000000000000000000000000000000000000000000000000000000000000000000000
00000000000000000000000021111112000000000000000000001111111122000000000000000000000000000000000000000000000000000000000000000000
00000000000000000000000021111100000000000000000000111111111222000000000000000000000000000000000000000000000000000000000000000000
00000000000000000000000011111200000000000000000011111111122222220000000000000000000000000000000000000000000000000000000000000000
00000000000000000000001111111200000000000000000011111112222222222200000000000000000000000000000000000000000000000000000000000000
00000000000000000000211111110000000000001100000000111222222222222111000000000000001100000000000000000000000011000000000000000000
00000000000000000000211111110000000000000000000000002222222222211111110000000000001100000000000000000000000000000000000000000000
00000000000000000000111112000000000000000000000000000022222221111111110000000000000000000000110000000000000000000000000002222000
00000000000000000021111112000000000000000000000000000000222111111111110000000000000000000000110000000000000000000000000002222000
00000000000000000021111111000000000000000000000000000000002111111111111100000000000000000000000000000000000000000000000000000000
00000000000000000011111211000000000000000000000000000000000011111111111111000000000000000000000000000000000000000000000000022000
00000000111111111111111200000000000000000000000000000000000011111111111111000000000000000000000000000000000000000000000000002200
00111111111111111111110000000000000000000000000000000000001111111111111111000000000000000000000000000000000000000000000000022011
11111111111111111111000000000000000000000000000000000002111111111111111111112200000000000000000000000000000000000000000000002211
11111111111111111100000000000000000000000000000000000222211111111111111111122200000000000000000000000000000000000000000000002211
11111111000000000000000000000000000000000000000000022222222111111111111112222222000000000000000000000000000000000000000000002211
11000000000000000000000000000000000000000000000002222222222221111111111222222222220000000000000000000000000000000000000000022011
00000022000000000000000000000000000000000000000022222222222222211111122222222222211100000000000000000000000000000000000000001111
00022002200000000000000000000000000000000000022222222222222222220000222222222221111111000000000000000000000000000000000000221111
00220000000000000000000000000000000000000022222222222222222222000000002222222111111111111111000000000000111100000000000011111111
00000000000000000000000000000000000000000011122222222222222200000000000022211111111111111111111111000011111112000000000011111111
02200000000000000000000000000000000000001111111222222222220000000000000000211111111111111111111111111111111122220000000011111111
00220000000000000000000000000000000000111111111112222222000000000000000000002111111111000000111111111111112222222200000000111100
00000000000000000000000000000000000011111111111111122200000000000000000000000011110000000000000000111111222222222222200000000000
02200000000000000000000000000000000011111111111111120000000000000000000000000000000000000000000000110000222222222211110000000011
00000000000000000000000000000000001111111111111111000000000000000000000000000000000000000000000000110000002222221111111111111111
00000000000000000000000000000000001111111111111100000000000000000000000000000000000000000000000000000000000022111111111111111111
00000000000000000000000011110000111111111100000000000000000000000000000000000000000000000000000000000000000000111111111111111111
00000000000000000000001111111111111100000000000000000000000000000000000000000000000000000000000000000000000000011111111111111111
00000000000000000000211111111111110000000000000000000000000000000000000000000000000000000000000000000000000000000011111111111111
00000000000000000002221111111111000000000000000000000000000000000000000000000000000000000000000000000000000000000000111111111111
11110000000000002222222211111100000000000000000000000000000000000000000000000000000000000000000000220000000000000000111111111111
11111111110002222222222222110000000000000000000000000000000000000000000000000000000000000000000000000000000000000000111111111111
11111111111111112222222222200000000000000000000000000000000011000000000000000000000000000000000000000000000000000000001111111111
11111111111111111122222220000000000000000000110000000000000000000000000000000000000000000000000000000000000000000000000011111111
11111111111111111111222000000000000000000000001100000000000000000000000000000000000000000000000000000000000000000000000011111111
11111111111111111111200000000000000000000000000000000000000000000000000000000000000000000000000000000000000000000000000011111111
11111111111111111112000000000000000000000000000000000000000000000000000000000000000000000000000000000000000000000000000000111111
11111111111111110000000000000000000000000000000000000000000000000000000000000000000000000000000000000000000000000000000000001111
11111111110000000000000000000000000000000000000000000000000000000000000000000000000000000000000000000000000000000000000220001111
11111111000000000000000000000000000000000000000000000000000000110000000000000000000000111100000000001100000000000000000000001111
11111111000000000000000000000000000000000000220000000000000000110000000000000000111111111111111100001100000000000000000220001111
11111111000011111122000000000000000000000000000000000000000000000000000000000011111111111111111111111122000000000000000000111111
11111100001111111100000000000000000000000000000000000000000000000000000000001111111111111111111111111111000000000220002200111111
11110000001111111122000000000000000000000000000000000000000000000000000000211111111111000011111111111111111111002222022000111111
11110000001111110220000000000000000000000000000000000000000000000000000000211111000000000000000011111111111111110000000000111111
11110000111111110000000000000000000000000000000000000021111111000000000000111112000000000000000000000011111111111100000000001111
11000011111111110220000000000000000000000000000000000021111111110000000011111112000000000000000000000000111111111111000000000011
00001111111111111122000000000000002111111100000000000021111111111100001111111100000000000000000000000000000000111111120000000000
00001111111111111122000000000000002111111111000000000000111111111111111111110000000000000000000000000000000000001111120000000000
00001111111111111102222022220000001111111111110000000000000000111111111111000000000000000000000000000000000000002111110000000000
00000011111111111100000022220000002111111111111100000000000021111111111100000000000000000000000000000000000000002111111100000000
11000011111111111111000000000000002111111111111112000000000021111111111200000000000000000000000000000000000000000011111112000000
11000011111111111111221100000000000011111111111112000000000021111111111200000000000000000000000000000000000000000000111112000000
00001111111111111111111111000000000021111111111112000000000000111111110000000000000000000000000000000000000000000000211111000000
00111211111111111111111111000000000011111111111100000000000000211111000000000000000000000000000000000000000000000000211111121100
11111111111111111111111111000000001111111111110000000000000000211112000000000000000000000000000000000000000000000000001111121100
11111111111111111111111111000000211122222211120000000000000000001112000000000000000000000000000000000000000000000000002111111100
11111111111111111111111100000000211122221111120000000000000000000000000000000000000000000000000000000000000000000000002111111100
11121111111111111111111100000000111122221111222200000000000000000000000000000000000000000000000000002200000000000000000011111111
11111111111111111111111100000000211122221112222200000000000000000021110000000000000000000000000000000000000000000000000000111111
11111111111111111111111100000000211111221111000000000000000000000021111200000000000000000000000000002200000000000000000000001111
11111111111111111111112200000000001111221111110000000000002200000011111200000000000000222200000000000220000000000000000000002111
11111111111111111111110000000000002111111111111102200022022000000021111100000000000000222200000000002200000000000000000000002111
11111111111111111111110000000000001111111111111112220222200000000021111112000000000000000000000000000220000000000000000000000011
11111111111111111111000000002111111111111111111112001111000000001111111112000000000000000000000000000000000000000000000000000000
11111111110011111100000000002111111111111111111111111111111111111111111112000000000000000000000000002200000000000000000000000000
11111111111111110011000000002111111111111111111111111111111111111111111100000000000000000000000000002200000000000000000000000000
11112111111111110000000000111111111111111111111111111111111111111111111200000000000000000000000002222000000000000000000000000000
11111111111111111100000021111111111111111111111111111111111111111111111100000000000000000000000000000000000000000000000000000000
11111111111111111100000021111111111111111111111111111111111111111111111111000000000000000000000000000000000000000000000000011111
11111111111111111111111111111111111111111111111111111111111111111111111111111111111111111111111111111111111111111111111111111111
