22022222222222222222222200000000000000000000000000000000000000002222200000000000000000000000000022220000000000000000000000000000
02222222022222222220022220000000000000000011000000000000000000222200000000000000000000000000000002222000000000000000000000000000
22222002222222222222222200000000000000000000000000000000000002220011000000000000000000000000000002222000000000000000000000000000
22222222222222222222222000000000000000000000000000000000000000222200000000000000000000000000000002222000000000000000000000000000
20022222222222222222202011000222000000000000000000000000000000022220000000000000000000000000000022220000000000000000000000000000
22222222022222222222222000000222222220000000000000000000000000222200000000000000000000000000002222000000000000000000000000000000
22222002222222220000222200002222222220000000000000000000000002220000000000000000000000000000022220000000000000000000000000000000
22222222220000000000002222222220022220000000000000000000000002201100000000000000000000000000002222000000000000000000000000000000
20022222000000000000000222222222222200000000000000000000000002200000000000000000000000000000000222200000000000000000000000000000
22222200000000000000000222200222222000000000000000000000000000000000000000000000000000000000000222200000000000000000000000000000
22222000000000000000000022222222222200000000000000000000000000000000000000000000000000000000000022220000000000000000000000000000
22222200000000000000000000222220022220000000000000000000000000000000000000000000000000000000000002222000000000000000000000000000
20022220000000000000000000002222222200000000000000000000000000000000001100000000000000000000000022220000000000000000000000000000
22222200000000000000000000000022222000000000000000000000000000000000000000000000000000000000000222200000000000000000000000000000
22222000000000000000000000000002222000000000000000000000000000000000000000000000000000000000000022220000000000000000000000000000
02222000000000000000000000000002222000000000000000000000000000000000000000000000000000000000000002222000000000000000000000000000
02222000000000000000000000000000222000000000000000000000000000000000000000000000000000000000000022220000000000000000000000000000
02222200000000000000000000000000000000000000000000000000000000000000000000000000000000000000000222200000000000000000000000000000
22222222000000000000000000000000000000000000000000000000000000000000000000000000000000000000000222200000000000000000000000000000
22200222200000000000000000000000000000000000000000000000000000000000000000000000000000000000002222000000000000000000000000000000
22222222000000000000000000000000000000000000000000000000000000000000000000000000000000000000222200000000000000000000000000000000
02222220000000000000000222000000000000000000000000000000000000000000000000000000000000000002222000000000000000000000000000000000
22222222222200000000000222200000000000000000000000000000000000000000000000000000000000000002222000000000000000000000000000000000
22200222222220000000000222200000000000000000000000000000000000000000000000000000000000022222222000001102220000000000000000000000
22222222000000000000000222200000000000000000000000000000000000000000000000000000000000022222222200000002222000000000000000000000
22222200000000000000000222200000000000000000000000000000000000000000000000000011000000222220022222222222222000000000000000000000
20000000000000000000000022220000000000000000000011000000000000000000000000000000000022222222222222222222222222200000000000000000
20000000000000000000000002222000000000000000000000000000000000000000000000000000000222200222222002200220022222200000000000000000
00000000000002222222000022220000000000000000000000001100000000000000000000000000000022222222222222222222222222220000000000000000
00000000000000222222222222200000000000001100000000000000000000000000000000000000001102222220022222222222220000222200000000000000
00000000000000000000222222220000000000000000000000000000000000000000000000000000000022222222222200000000000000022220000000000000
00000000000000000000000002222000000000110000000000000000000000000000000000000000000202222222222000000000000000022220000000000000
00000000000000000000000002222000000000110000000000000000000000000000000000000000000222222222202000000000000000002222000000000000
00000000000000000000000002222000000000000000000000000000000000000000000000000000002222222222222000000000000000000022200000000000
00000000000000000000000002222011000000000000000000000000000000000000000000000000020222222222222000000000000000000000000000000000
00000000000000000000000000222200000000000000000000000000000000000000000000000000022222222220220000000000000000000000000000000000
00000000000000000000000000022220000000000000000000000000000000000000000000000000020222222222200000000000000000000000000000000000
00000000000000000000000000022220000000000000000000000000000000000000000000000000022222222222200000000000000000000000000000000000
00000000000000000000000000002222000000000000000000000000110000000000000000000000022222222022000000000000000000000000022200000000
00000000000000000000000000000022220000000000000000000000000000000000000000000000002202222220000000000000000000000000022222222222
00000000000000000000000000000002222000000000000000000000000000000000000000000000000222222222000000000000000000000000222222222222
00000000000000000000000000000022220000000000000000000000000000000000000000000000000222200222200000000000000000022222222000000000
00000000000000000000000000000222200000000000000000000000000000000000000000000000000222222222200000000000000000002222222200000000
00000000000000000000000000000222200000000000000000000000000000000000000000000000002222220222220000000000000000000000002220000011
00000000000000000000000000000222200000000000000000000000000000000000000000000000022220022222222222220000000000000000000000000000
00000000000000000000000000000022220000000000000000000000000000000000000000000000002222222220022222222200000000000000000000000000
00000000000000000000000000000002222000000000000000000000000000000000001100000000000022222222222220022222000000000000000000000000
00000000000000000000000000000022220000000000000000000000000000000000000000000000000000000222222222222222200000000000000000000000
00000000000000000000000000000222200000000000000000000000000000000000000000000000000000000222200222222000000000000000000000000000
00000000000000000000000000000222200000000000000000000000000000000000000000000000000000000222222222222000000000000000000000000000
00000000000000000000000000002222000000000000000000000000000000000000000000000000000000000222222200000000000000000000000000000000
00000000000000000000000000022220000000000000000000000000000000000000000000000000000000000000000000000000000000000000000000000000
00000000000000000000000000002222000000000000000000000000000011000000000000000000000000000000000000000000000000000000000000000000
00000000000000000000000000000222200000000000000000000000000011000000000000000000000000000000000000000000000000000000000000000000
00000000000000000000000000002222000000000000000000000000000000000000000000000000000000000000000000000000000000000000000000000000
00000000000000000000000000022220000000000000000000000000000000000000000000000000000000000000000000000000000000000000000000000000
00000000000000000000000000022220000000000000000000000000000000000000000000000000000000000000000000000000000000000000000000000000
00000000000000000000000000222200000000000000000000000000000000000000000000000000000000000000000000000000000000000000000000000000
00000000000000000000000002222000000000000000000000000000000000000000000000000000000000000000000000000000000000000000000000000000
00000000000000000000000002222000000000000000000000000000000000000000000000000000000000000000000000000000000000000000000000000000
00000000000000000000000022220000000000000000000000000000000000000000000000000000000000000000000000000000000000000000000000000000
00000000000000000000002222000000000000001100000000000000000000000000000000000000001100000000000000000000000011000000000000000000
00000000000000000000022220110000000000000000000000000000000000000000000000000000001100000000000000000000000000000000000000000000
00000000000000000000022220000000000000000000000000000000000000000000000000000000000000000000110000000000000000000000000000000000
00000000000000000000222200000000000000000000000000000000000000000000000000000000000000000000110000000000000000000000000000000000
00000000000000000002222000000000000000000000000000000000000000000000000000000000000000000000000000000000000000000000000000000000
00000000000000000002222011000000000000000000000000000000000000000000000000000000000000000000000000000000000000000000000000000000
00000000000000000022220000000000000000000000000000000000000000000000000000000000000000000000000000000000000000000000000000000000
00000000222222222222000000000000000000000000000000000000000000000000000000000000000000000000000000000000000000000000000000000000
00222222222222222200000000000000000000000000000000000000000000000000000000000000000000000000000000000000000000000000000000000002
22222222000000000000000000000000000000000000000000000000000000000000000000000000000000000000000000000000000000000000000000000000
22000000000000000000000000000000000000000000000000000000000000000000000000000000000000000000000000000000000000000000000000000002
00000000000000000000000000000000000000000000000000000000000000000000000000000000000000000000000000000000000000000000000000000000
00000000000000000000000000000000000000000000000000000000000000000000000000000000000000000000000000000000000000000000000000000022
00000000000000000000000000000000000000000000000000000000000000000000000000000000000000000000000000000000000000000000000000000222
00000000000000000000000000000000000000000000000000000000000000000000000000000000000000000000000000000000000000000000000002000022
00000000000000000000000000000000000000000000000000000000000000000000000000000000000000000000000000000000000000000000000002222222
00000000000000000000000000000000000000000000000000000000000000000000000000000000000000000000000000000000000000000000000000222200
00000000000000000000000000000000000000000000000000000000000000000000000000000000000011000000000000000000000000000000000000000000
00000000000000000000000000000000000000000000000000000000000000000000000000000000000000000000000000000000000000000000000000000000
00000000000000000000000000000000000000000000000000000000000000000000000000000000000000000000000000000000000000000000000000000000
00000000000000000000000000000000001100000000000000000000000000000000000000000000000000000000000000110000000000000000000000000000
00000000000000000000000000000000000000000000000000000000000000000000000000000000000000000000000000000000000000000000000000000000
00000000000000000000000000000000000000000000000000000000000000000000000000000000000000000000000000000000000000000000000000000000
00000000000000000000000000000000000000000000000000000000000000000000000000000000000000000000000000000000000000000000000000000000
00000000000000000000000000000000000000000000000000000000000000000000000000000000000000000000000000000000000000000000000000000000
00000000000000000000000000000000000000000000000000000000000000000000000000000000000000000000000000000000000000000000000000000000
00000000000000000000000000000000000000000000000000000000000000000000000000000000000000000000000000110000000000000000000000000000
00000000000000000000000000000000000000000000000000000000000000000000000000000000000000000000000000000000000000000000000000000000
00000000000000000000000000000000000000000000000000000000000011000000000000000000000000000000000000000000000000000000000000000000
00000000000000000000000000000000000000000000110000000000000000000000000000000000000000000000000000000000000000000000000000000000
00000000000000000000000000000000000000000000001100000000000000000000000000000000000000000000000000000000000000000000000000000000
00000000000000000000000000000000000000000000000000000000000000000000000000000000000000000000000000000000000000000000000000000000
00000000000000000000000000000000000000000000000000000000000000000000000000000000000000000000000000000000000000000000000000000000
00000000000000000000000000000000000000000000000000000000000000000000000000000000000000000000000000000000000000000000000000000000
00000000000000000000000000000000000000000000000000000000000000000000000000000000000000000000000000000000000000000000000000000000
00000000000000000000000000000000000000000000000000000000000000000000000000000000000000000000000000001100000000000000000000000000
00000000000000000000000000000000000000000000110000000000000000110000000000000000000000222200000000001100000000000000000000000000
00000000000011020000000000000000000000000000000000000000000000000000000000000000222222222222222200000011000000000000000000000000
00000000001100222000000000000000000000000000000000000000000000000000000000000022222222000022222222222200000000000000000000000000
00000000000022220000000000000000000000000000000000000000000000000000000000002222000000000000000022222222000000000000000000000000
00000000000222200000000000000000000000000000000000000000000000000000000000022220000000000000000000000022222222000000000000000000
00000000110022200000000000000000000000000000000000000000000000000000000000022220000000000000000000000000222222220000000000000000
00000011002222200000000000000000000000000000000000000002222222000000000000222200000000000000000000000000000000222200000000000000
00001100222222220000000000000000000000000000000000000000222222220000000022220000000000000000000000000000000000002222000000000000
00001102222002222000000000000000000222222200000000000000000000222200002222000000000000000000000000000000000000000222200000000000
00000002222002222000000000000000000222222222000000000000000000022222222200000000000000000000000000000000000000000222200000000000
00000002222000222000000000000000000222200222220000000000000000222222222000000000000000000000000000000000000000000022220000000000
00000000222222222000000000000000000022222222222200000000000002222002222000000000000000000000000000000000000000000000222200000000
00000000022222222200000000000000000002222220022220000000000000222222220000000000000000000000000000000000000000000000022220000000
00001110022200022222000200000000000002222222222200000000000000022222000000000000000000000000000000000000000000000000022220000000
00011001002222222222222220000000000002200222220000000000000000022220000000000000000000000000000000000000000000000000002222000000
11000000222202220000222200000000000022222222200000000000000000002220000000000000000000000000000000000000000000000000000222201100
00022002220002222200022011000000002222222222200000000000000000000000000000000000000000000000000000000000000000000000000222201100
00000000222222222222222000000000020222222022000000000000000000000000000000000000000000000000000000000000000000000000000022220000
00000022222222000222220000000000022222222220000000000000000000000000000000000000000000000000000000000000000000000000000000222200
22200222000022222222201100000000022222222020000000000000000000000000000000000000000000000000000000000000000000000000000000002222
22000022220002222200110000000000002202222220000000000000000000000002220000000000000000000000000000000000000000000000000000000222
20002222022222222222000000000000000222222222000000000000000000000002222000000000000000000000000000000000000000000000000000000222
22222200022222000222200000000000000202222222220000000000000000000002222000000000000000000000000000000000000000000000000000000022
22222222222222222222000000000000000222222222222200000000000000000000222200000000000000000000000000000000000000000000000000000000
22200222222002222200000000000000002222200220022220000000000000000000022220000000000000000000000000000000000000000000000000000000
33222222000002222000000000000222222222222222222220002222000000002222222200000000000000000000000000000000000000000000000000000000
22322332220000200011000000000022222002222222222222222222222222222222222000000000000000000000000000000000000000000000000000000000
22322222332222200000000000000002222222222002200222222002222222222002222000000000000000000000000000000000000000000000000000000000
23233233223222201100000000222222222222222222222222222222222002222222222000000000000000000000000000000000000000000000000000000000
22222233222222200000000002222222200220022222222220022222222222222222222200000000000000000000000000000000000000000000000000000000
22333322333222200000000000000022222222222200022222222200002222000000022222000000000000000000000000000000000000000000000000000011
