1122100112
1201210112
1011212022
0012000012
2221121220