XXXXXXXXXXXXXXXXXXXXXXXXXXXXXXXXXXXXXXXXXXXXXXXXXXXXXXXXXXXXXXXXXXXXXXXXXXXXXXXXXXXXXXXXXXXXXXXXXXXXXXXXXXXXXXXXXXXXXXXXXXXXXXXXXXXXXXXX
X...........................XX..XXXXXX.................................................................................................X
X.........................XX..........X.....................................XXXXXXXX...................................................X
X.......................XX.............X................................XXXX........XXX.....................XX......XXXX...............X
X......................X................X..............................X...............X...................X..X....X....X..............X
X.....................X..................XX...........................X.................X...............XXX....XXXX......XXXXX.........X
X....................X.....................X..........................X..................X.............X......................X........X
X...................X.......................X........................X...................X............X........................X.......X
X..................X.........................X...XX...........XXXX..X....................X...........X..........................X......X
X..................X..........................XXX..XXX.......X....XX.....................X..........X............................X.....X
X.................X...................................X.....X............................X.........X.............................X.....X
X.................X....................................X....X.............................X.......X..............................X.....X
X.................X....................................X...X..............................X.......X...............................X....X
X......XXXXXXXXXXX..................XXX................XXXX...............................X.......X................................X...X
X....XX.............................X..X..................................................X......X.................................X...X
X...X.........................XXXXXX....X................................................X......X..................................X...X
X..X..........................X..X..X...X................................................X......X..................................X...X
X.X........................XXXXXX....X..X................................................X......X..................................X...X
X.X.......................X..X........X..X...............................................X......X...................................X..X
XX.......................X..X.........X..X...............................................X.......X...................................X.X
X.......................X..X...........XX.................................................X.......X..................................X.X
X.......................X.X...........................................XXXX................X.......X.................................X..X
XX......................XX.............................XXXXX..........X...X...............X.......X................................X...X
XX......................X..............................X....X..........X..X..............X.........X...............................X...X
XX......................X..............................X.....X..........XX.............XX...........X...............................X..X
XX.....................XX.............................X.......X.......................X.............X................................X.X
X.X.................XXXX.............................X........X.......................X.............X................................X.X
X.X.................X.X..............................X........X.......................X......X......X...............................X..X
X.X................X..X..............................X.........X.......................X...XX.XXX...X..............................X...X
X..X...............X...X.............................X..........X.......................XXX......XX..X.............................X...X
X...X..............X....X............................X..........X..................................XX.XXX..........................X...X
X...X..............X....X............................XXXXX......X....................................XX..X........................X....X
X...X..............X....X.................................X.....X...............XXX....................X..X..........XXXXXX......X.....X
X....XX.............X...X..................................X.....X.............X...X....................X.X..........X.X..XX....X......X
X......X.............X..X.................................X.....X..............X..X......................XX..........X.X...XXXXXX......X
X.......X.............XXX.................................X..XXX................XX......................X..X..........XX.........X.....X
X........X.................................................XX...........................................X...X....XXX...X..........X....X
X.........X.............................................................................................X....X..X...X..............X...X
X..........X.............................XXXXXX.....................XXXX.................................X....XXXXXXXX..............X..X
X...........XXX....................XX...X.....X....................X....X...............................X.....X......................X.X
X..............X..................X..XXX......X....................X....X...............................X....X.......................X.X
X.......XXXX....X.................X............X...................X.....XXXX...........................X...X........................X.X
X......X....X...X..................XX...........X..................X.........XXX.........................X..X.........................XX
X...XXX......X..X....................X..........X...................XXX.........X.......................X...X..........................X
X..X..........X..X...................X..........X......................X........X.......................X...X..........................X
X.X...........X..X....................X........X.......................X........X.......................X....X.........................X
X.X............XX......................XXXXXXXX.........................X.......X........................X....X........................X
X.X......................................................................X......X.........................XXXXX........................X
XX..................................................XXX...................X....X.......XXX.............................................X
X..................................................X...X...................X...X.......X.X............................................XX
X.................................................X.....X...................X..X.......XXX.........XXXX..............................X.X
X.................................................X......X...................X.X...............XXXX...X..............................X.X
X........................XXXXX....................X.......X..................X.X...............X......X..............................X.X
X........................X....X...................X.......X.................X.X.................X....XX.............................X..X
X........................X.....X...................X......X................X..X.................X...X..............................X...X
X........................X.....X...................X.....X................X...X.................X...X................XX............X...X
X........................X.....X....................X...X...XXXX.........X.....X................X...X...............X..X...........X...X
X........................X......X....................XXX...X....X....XX.X......X................X...X...............X..X..........X....X
X.........................X......X.........................X....X...X..X.......X................X..X...............X..X..........X.....X
XX.........................X.....X.........................X....X...X.........X.................X.X................X...X........X......X
X.X........................X....X..........................X.....XXX.........X..................X.X................X....XXXXXXXX.......X
X.X........................XXXXX............................XX.....X..XXXXXXX..................X..X................X...................X
X.X...........................................................XXXXX.XX........................X....X................X..................X
X..X.................................................................XX......................X.....X.................X.................X
X...XXX.............................................................XX......................X.....X..................X.................X
X......X...............................XXXX........................XX.......................X.....X..................XXX...............X
X.......XXXXXXX.......................X....X................................................X.....X.....................X..............X
X..............X.....................X.....X................................................X....X.......................XXXXXXX.......X
X...............XXX..................X.....X.......................XX........................XXXX...............................X......X
X.................X..................X.....X......................XX.............................................................XXX...X
X.................X.................X.....X......................XX.................................................................X..X
X..................X................X....X........................XX.XXXXX...........................................................X.X
X...................X................X..X..................XXXXXXXX.X.....XX............................XXXXX........................X.X
X.......XXXXXXXX....X................X.X..................X........XXXX.....X..........................X....X........................X.X
X......X........X...X................X.X.................X.........X...X....X.........................X.....X.........................XX
X.....X..........X..X...............X..X................X.......X..X...X....X.........................X......X.........................X
X....X..........X..X...............X...X................X......X.XX....X....X...XXX....................X......X........................X
X...X...........X..X...............X...X................X.....X.........XXXX...X...X....................X.....X........................X
X...X............XX................X...X.................X...X................X.....X...................X.....X........................X
X...X..............................X...X.................X..X................X......X...................X.....X........................X
X..X.............................XX....X.................X.X.................X.......X...................X....X........................X
X.X..............................X......X...............X.X..................X.......X....................XXXXX........................X
X.X..............................X...XXXX...............X.X...................X......X.................................................X
X.X..............................XXXX.........XXX.......X..X...................X.....X.................................................X
XX............................................X.X.......X...X...................X...X..................................................X
X.............................................XXX.......X....X...................XXX..................................................XX
X........................XXXXX.........................X......X......................................................................X.X
X........................X....X........................X.......X.........................XXXXXXXX......................XX............X.X
X.........................X....X.......................X........X.......................X........X....................X..X...........X.X
X..........................X...X.......................X........X......................X..........X...................X..X..........X..X
X..........................X...X.......................X.........XXX...................X..........X....................X..X......XXX...X
XX.........................X..X.........................XXX.........X..................X...........XX..................X...X....X......X
X.X........................X...X...........................XXXX.....X...................X............X.................X....XXXX.......X
X.X.......................X....X...............................X....X....................X......XXX..X..................X..............X
X.X......................X.....X...............................X....X....................X.....X...XX....................XXX...........X
X..X..............XXXXXXXX....X.................................XXXX.....................XXXXXX.............................X..........X
X...X..............X...X..X....X.............................................................................................X.........X
X....X..........X...XXX....X...X...........................................XX.................................................X........X
X.....X.........XX..........X..X......................XX................XXX..X.................................XXX.............X.......X
X......XXXXXX...X.X..........XX......................X..X..............X.....X.................................X..X.............X......X
X......X....XX..X.X..........X.X....................X...X.............X.....X..................................X...X.............XX....X
X.....X......XXXXXX..........X..X....................XXX...............X.....X.................................X....X..............X...X
X....X........................X..XX....................................X......XXXXX............................X....X..............X...X
X...X..........................XXX.XX..................................X..........X............................X....X..............X...X
X...X.............................X..XX......XXX.......................X..........X.............................X...X...............X..X
X...X..............................X...XXX.XX...X.......................X.........X..............................X..X................X.X
X..X...............................X......X......X.......................X........X..............................X.X.................X.X
X.X................................X.............X.......................X........X.............................XXXX.................X.X
X.X................................X.............X.......................X.......X.............................XX.....................XX
X..X...............................X...........XX.............XX..........X.....X..............................X......................XX
X...X...............................X.........X..............X..X..........X....X..............................X......................XX
X...X................................X.......X...............X...X..........XXXXX.............................XX......................XX
X..X.................................X.......X................XXXX...........................................X.X.......................X
X.X..................................X.......X.................................................XX...........X..X.......................X
X.X...................................X.......X...............................................X..X.........X..X.......................XX
X..X...................................X......X...............................................X..X........X..X.......................X.X
X...X..................................X......X................................................X..X....XXXXXX........................X.X
X...X..................................X......X................................................X...X..X..X..........................X..X
X...X..................................X......X................................................X....XXXXXX.........................X...X
X...X.................................X......X..................................................X..X.............................XX....X
X...X................................X.......X...............................XXXX................XXX..................XXXXXXXXXXX......X
X....X...............................X.......X..............................X...X....................................X.................X
X.....X..............................X.......X.............................X....X....................................X.................X
X.....X.............................X.........X............................X.....X...................................X.................X
X.....X............................X..........X.....................XX....X.......XXX..XXX..........................X..................X
X......X..........................X...........X....................X..XXXX...........XX...X.........................X..................X
X.......X........................X............X...................X........................X.......................X...................X
X........X......................X.............X..................X..........................X.....................X....................X
X.........XXXXX......XXXX....XXX...............X.................X...........................XX..................X.....................X
X..............X....X....X..X...................X...............X..............................X................X......................X
X...............XXXX......XX.....................XXX........XXXX................................X.............XX.......................X
X...................................................XXXXXXXX.....................................X..........XX.........................X
X.................................................................................................XXXXXX..XX...........................X
XXXXXXXXXXXXXXXXXXXXXXXXXXXXXXXXXXXXXXXXXXXXXXXXXXXXXXXXXXXXXXXXXXXXXXXXXXXXXXXXXXXXXXXXXXXXXXXXXXXXXXXXXXXXXXXXXXXXXXXXXXXXXXXXXXXXXXXX
