AAAAAAAAAAAAAAAAAAAAAAAAAAAAAAAAAAAAAAAAAAAAAAAAAAAAAAAAAAAAAAAAAAAAAAAAAAAAAAAAAAAAAAAAAAAAAAAAAAAAAAAAAAAAAAAAAAAAAAAAAAAAAAAA
AA..AAAAAAAAAA....AAAAAAAAAAAAAAAAAAAAAAAAAAAAAAAAAAAAAAAAAAAAAAAAAAAAAAAAAAAAAAAAAAAAAAAAAAAAAAAAAAAAAAAAAAAA....AAAAAAAAAA..AA
A..AAAAAAAAAAA....AAAAAAAAAAAAAAAAAAAAAAAAAAAAAAAAAAAAAAAAAAAAAAAAAAAAAAAAAAAAAAAAAAAAAAAAAAAAAAAAAAAAAAAAAAAA....AAAAAAAAAAA..A
AA..AAAAAAAAAAAAAAAAAAAAAAAAAAAAAAAAAAAAAAAAAAAAAAAAAAAAAAAAAAAAAAAAAAAAAAAAAAAAAAAAAAAAAAAAAAAAAAAAAAAAAAAAAAAAAAAAAAAAAAAA..AA
AA..AAAAAAAAAAAAAAAAAAAAAAAAAAAAAAAAAAAAAA;;;;AAAAAAAAAAAAAAAAAAAAAAAAAAAAAAAAAAAA;;;;AAAAAAAAAAAAAAAAAAAAAAAAAAAAAAAAAAAAAA..AA
A..AAAAAAAAAAAAAAAAAAAAAAAAAAAAAAAAA;;;;;;;;;;;;AAAAAAAAAAAAAAAAAAAAAAAAAAAAAAAA;;;;;;;;;;;;AAAAAAAAAAAAAAAAAAAAAAAAAAAAAAAAA..A
AAAAAAAAAAAAAAAAAAAAAAAAAAAAAA;;;;AA;;;;;;;;;;;;;;;;;;AAAAAAAAAAAAAAAAAAAA;;;;;;;;....;;;;;;AA;;;;AAAAAAAAAAAAAAAAAAAAAAAAAAAAAA
A..AAAAAAAAAAAAAAAAAAAAAAAAAAA;;;;;;;;;;..;;;...;;;;;;AAAAAAAAAAAAAAAAAAAA;;;;;;........;;;;;;;;;;AAAAAAAAAAAAAAAAAAAAAAAAAAA..A
A..AAAAAAAAAAAAAAAAAAAAAAA;;;;;;;;;;;;............;;;;AAAAAAAAAAAAAAAAAAAA;;;;............;;;;;;;;;;;;AAAAAAAAAAAAAAAAAAAAAAA..A
AA..AAAAAAAAAAAAAAAA;;;;AA;;;;;;....................;;;;AAAAAAAAAAAAAAAA;;;;....................;;;;;;AA;;;;AAAAAAAAAAAAAAAA..AA
AAAAAAAAAAAAAAAAAAAA;;;;;;;;;;......................;;;;..AAAAAAAAAAAA..;;;;......................;;;;;;;;;;AAAAAAAAAAAAAAAAAAAA
AAAAAAAAAAAAAAAAAAAA;;;;;;;;........................;;;;...AAAAAAAAAA...;;;;........................;;;;;;;;AAAAAAAAAAAAAAAAAAAA
AAAAAAAAAAAAAAAAAAAAAA;;;;............................;;;;AAAAAAAAAAAA;;;;............................;;;;AAAAAAAAAAAAAAAAAAAAAA
AAAAAAAAAAAAAAAAAAAA;;;;;;............................;;;;............;;;;............................;;;;;;AAAAAAAAAAAAAAAAAAAA
;;AAAAAAAAAAAAAAAAAA;;;;;;............................;;;;;;;;....;;;;;;;;............................;;;;;;AAAAAAAAAAAAAAAAAA;;
;;;;AAAA;;;;AAAA;;;;;;;;................................;;;;;;;;;;;;;;;;................................;;;;;;;;AAAA;;;;AAAA;;;;
;;;;AAAA;;;;;;AA;;;;;;........................................;;;;........................................;;;;;;AA;;;;;;AAAA;;;;
;;;;AAAA;;;;;;;;;;;;;;....................................................................................;;;;;;;;;;;;;;AAAA;;;;
;;;;AAAA;;;;;;;;;;;;;;;;................................................................................;;;;;;;;;;;;;;;;AAAA;;;;
;;;;AAAA;;;;;;;;;;;;;;;;;;............................................................................;;;;;;;;;;;;;;;;;;AAAA;;;;
;;;;AAAA;;;;;;;;;;....;;;;;;........................................................................;;;;;;....;;;;;;;;;;AAAA;;;;
;;;;AAAA;;;;;;;;..A..A..;;;;;;....................................................................;;;;;;..A..A..;;;;;;;;AAAA;;;;
;;AAAAAAAA;;;;AAAAAAAAAA..;;;;....................................................................;;;;..AAAAAAAAAA;;;;AAAAAAAA;;
AAAAAAAAAAAAAAAAAAAAAAAAAA;;;;....................................................................;;;;AAAAAAAAAAAAAAAAAAAAAAAAAA
AAAAAAAAAAAAAAAAAAAAAAAAAA;;;;;;..............;;................................;;..............;;;;;;AAAAAAAAAAAAAAAAAAAAAAAAAA
;;;;AAAAAAAAAAAAAAAAAAAA....;;;;..............;;................................;;..............;;;;....AAAAAAAAAAAAAAAAAAAA;;;;
;;;;AAAAAAAAAAAAAAAAAAAA....;;;;................................................................;;;;....AAAAAAAAAAAAAAAAAAAA;;;;
;;;;AAAAAAAAAAAAAAAAAAAAAAAA;;;;................................................................;;;;AAAAAAAAAAAAAAAAAAAAAAAA;;;;
;;;;AAAAAAAAAAAAAAAAAAAAAAAA;;;;................................................................;;;;AAAAAAAAAAAAAAAAAAAAAAAA;;;;
AAAAAAAAAAAAAAAAAAAAAAAAAAAA;;;;................................................................;;;;AAAAAAAAAAAAAAAAAAAAAAAAAAAA
AAAAAAAAAAAAAAAAAAAAAAAAAAAA;;;;................................................................;;;;AAAAAAAAAAAAAAAAAAAAAAAAAAAA
AAAAAAAAAAAAAAAAAAAAAAAAAAAA;;;;................................................................;;;;AAAAAAAAAAAAAAAAAAAAAAAAAAAA
AAAAAAAAAAAA;;;;AAAAAAAAAAAA;;;;................................................................;;;;AAAAAAAAAAAA;;;;AAAAAAAAAAAA
AAAAAAAA...;;;;;;;AAAAAAAAAA;;;;;.............................;;;;.............................;;;;;AAAAAAAAAA;;;;;;;...AAAAAAAA
AAAAAA.......;;;;;;;AAAAAAAAAA;;............................;;;;;;;;............................;;AAAAAAAAAA;;;;;;;.......AAAAAA
AAAA..........;;;;;;AAAAAAAA.;;............................;;;;;;;;;;............................;;.AAAAAAAA;;;;;;..........AAAA
AA............;;;;;;AAAAAAAA;;..............................;;BBBB;;..............................;;AAAAAAAA;;;;;;............AA
............CCCC;;;;AAAAAAAA.................................;;..;;.................................AAAAAAAA;;;;CCCC............
;.........CCCC;;;;AAAAAAAAAA..................................;;;;..................................AAAAAAAAAA;;;;CCCC........;;
;;;.....CCCCCC;;;;AAAAAAAAAAAA....................................................................AAAAAAAAAAAA;;;;CCCCCC.....;;;
;;;;..CCCCCCCC;;;;;...AAAAAAAAAA................................................................AAAAAAAAAA...;;;;;CCCCCCCC..;;;;
CCCCCCCCCCCCCCCC;.......AAAAAAAAAA............................AAAA............................AAAAAAAAAA.......;CCCCCCCCCCCCCCCC
CCCCCCCCCCCCCCCC..........AAAAAAAAAA........................AAAAAAAA........................AAAAAAAAAA..........CCCCCCCCCCCCCCCC
CCCCCCCCCCCCCCCC............AAAAAAAAAA....................AAAAAAAAAAAA....................AAAAAAAAAA............CCCCCCCCCCCCCCCC
CCCCCCCCCCCCCCCCCC............AAAAAAAAAA................AAAAAAAAAAAAAAAA................AAAAAAAAAA............CCCCCCCCCCCCCCCCCC
CCCCCCCCCCCCCCCCCCCC............AAAAAAAAAA............AAAAAAAAAAAAAAAAAAAA............AAAAAAAAAA............CCCCCCCCCCCCCCCCCCCC
CCCCCCCCCCCCCCCCCCCCCC............AAAAAAAAAA........AAAAAAAAAA....AAAAAAAAAA........AAAAAAAAAA............CCCCCCCCCCCCCCCCCCCCCC
CC..CCCCCCCCCCCCCCCCCCCC............AAAAAAAAAA....AAAAAAAAAA........AAAAAAAAAA....AAAAAAAAAA............CCCCCCCCCCCCCCCCCCCC..CC
C..CCCCCCCCCCCCCCCCCCCCCCC............AAAAAAAAAAAAAAAAAAAA............AAAAAAAAAAAAAAAAAAAA............CCCCCCCCCCCCCCCCCCCCCCC..C
CCCCCCCCCCCCCCCCCCCCCCCCCCCC............AAAAAAAAAAAAAAAA................AAAAAAAAAAAAAAAA............CCCCCCCCCCCCCCCCCCCCCCCC..CC
C..CCCCCCCCCCCCCCCCCCCCCCCCCCC............AAAAAAAAAAAA....................AAAAAAAAAAAA............CCCCCCCCCCCCCCCCCCCCCCCCCCC..C
CC..CCCCCCCCCCCCCCCCCCCC;;;;CCCC............AAAAAAAA........................AAAAAAAA............CCCC;;;;CCCCCCCCCCCCCCCCCCCCCCCC
C..CCCCCCCCCCCCCCCCCCCCC;;;;;;CCCC............AAAA............CCCC............AAAA............CCCC;;;;;;CCCCCCCCCCCCCCCCCCCCC..C
CC..CCCCCCCCCCCCCCCCCCCC;;;;;;;;CCCC........................CCCCCCCC........................CCCC;;;;;;;;CCCCCCCCCCCCCCCCCCCC..CC
CCCCCCCCCCCCCCCCCCCCCCCC;;;;;;;;;.CCCC........;;;;........CCCC;;;;CCCC........;;;;........CCCC;;;;;;;;;;CCCCCCCCCCCCCCCCCCCCCCCC
CCCCCCCCCCCCCCCCCCCCCCCC;;;;;;;;;;CC.........;;;;;;.....CCCC;;;;;;;;CCCC.....;;;;;;.........CC;;;;;;;;;;CCCCCCCCCCCCCCCCCCCCCCCC
CCCCCCCCCCCCCCCCCCCCCCCC;;;;;;;;;;..........;;;;;;;;..CCCC;;;;;;;;;;;;CCCC..;;;;;;;;..........;;;;;;;;;;CCCCCCCCCCCCCCCCCCCCCCCC
CCCCCCCC;;;;CCCCCCCCCCCC;;;;;;;;CC..........CCCCCCCCCCCC;;;;;;;;;;;;;;;;CCCCCCCCCCCC..........CC;;;;;;;;CCCCCCCCCCCC;;;;CCCCCCCC
CC;;;;;;;;;;;;;;;;CCCC..CC;;;;;;CC............CCCCCCCC;;;;;;;;;;;;;;;;;;;;CCCCCCCC............CC;;;;;;CC..CCCC;;;;;;;;;;;;;;;;CC
;;;;;;;;DDDD;;;;;;;;..CCCCCC;;;;CC..............CCCC;;;;;;;;;;;;;;;;;;;;;;;;CCCC..............CC;;;;CCCCCC..;;;;;;;;EEEE;;;;;;;;
;;DDDDDDDDDDDDDD;;;;CCCCCCCCCCCCCC....FFFF......CC;;;;;;;;;;;;;;;;;;;;;;;;;;;;CC......GG......CCCCCCCCCCCCCC;;;;EEEEEEEEEEEEEE;;
DDDDDDDDDDDDDDDD;;;;CCCCCCCCCCCCCC............CC;;;;;;;;;;;;;;;;;;;;;;;;;;;;;;;;CC............CCCCCCCCCCCCCC;;;;EEEEEEEEEEEEEEEE
DDDDDDDDDDDDDDDD;;;;CCCCCCCCCCCCCCCC........CC;;;;;;;;;;;;;;;;;;;;;;;;;;;;;;;;;;;;CC........CCCCCCCCCCCCCCCC;;;;EEEEEEEEEEEEEEEE
DDDDDDDDDDDD...;;;;;CCCCCCCCCCCCCCCCCC....CC;;;;;;;;;;;;;;;;;;;;;;;;;;;;;;;;;;;;;;;;CC....CCCCCCCCCCCCCCCCCC;;;;;...EEEEEEEEEEEE
DDDDDDDDDDDD;;...;CCCCCCCCCCCCCCCCCCCCCCCC;;;;;;;;;;;;;;;;;;;;;;;;;;;;;;;;;;;;;;;;;;;;CCCCCCCCCCCCCCCCCCCCCCCC;...;;EEEEEEEEEEEE
DDDDDDDDDD;;;;;...CCCCCCCCCCCCCCCCCCCCCC;;;;;;;;;;;;;;;;;;;;;;;;;;;;;;;;;;;;;;;;;;;;;;;;CCCCCCCCCCCCCCCCCCCCCC...;;;;;EEEEEEEEEE
DDDDDDDD;;;;;;;;..CCCCCCCCCCCCCCCCCCCC;;;;;;;;;;;;;;;;;;;;;;;;;;;;;;;;;;;;;;;;;;;;;;;;;;;;CCCCCCCCCCCCCCCCCCCC..;;;;;;;;EEEEEEEE
DDDDDDDD;;;;;;CCCCCCCCCCCCCCCCCC....CC;;;;;;;;;;;;;;;;;;;;;;;;;;;;;;;;;;;;;;;;;;;;;;;;;;;;CC....CCCCCCCCCCCCCCCCCC;;;;;;EEEEEEEE
DDDDDDDDDD;;;;CCCCCCCCCCCCCCCCCC....CC;;;;;;;;;;;;;;;;;;;;;;;;;;;;.;;;;;;;;;;;;;;;;;;;;;;;CC....CCCCCCCCCCCCCCCCCC;;;;EEEEEEEEEE
DDDDDDDDDDDD;;;;CCCCCCCCCCCCCCCCCCCCCC;;;;;;;;;;;;;;;;;;;;;;;;;;;;;;;;;;;;;;;;;;;;;;;;;;;;CCCCCCCCCCCCCCCCCCCCCC;;;;EEEEEEEEEEEE
DDDDDDDDDDDDDD;;;;CCCCCCCCCCCCCCC..CCC;;;;;;;;;;;;;;;;;;;;;;;;;;;;;;;;;;;;;;;;;;;;;;;;;;;;CCC..CCCCCCCCCCCCCCC;;;;EEEEEEEEEEEEEE
DDDDDDDDDDDDDDDD;;;;CCCCCCCCCCCC..CC;;;;;;;;;;;;;;;;;;;;;;;;;;;;;;;;;;;;;;;.;;;;;;;;;;;;;;;.CC..CCCCCCCCCCCC;;;;EEEEEEEEEEEEEEEE
DDDDDDDDDDDDDDDD;;;;CCCCCCCCCCCCCCCC;;;;;;;;;;;;;;;;;;;;;;;;;;....;;;;;;;;;;;;;;;;;;;;;;;;;;CCCCCCCCCCCCCCCC;;;;EEEEEEEEEEEEEEEE
DDDDDDDDDDDDDDDD;;;;CCC..CCC..C..CCC;;;;;;;;;;;;;;;;;;;;HHH..H....H....H;;;;;;;;;;;;;;;;;;;;CCC..C..CCC..CCC;;;;EEEEEEEEEEEEEEEE
DDDDDDDDDDDDDDDDDD;;;;CCC......CCC;;;;;;;;;;;;;;;;;;;;;;H..HHHHHHHHHHHHH;;;;;;;;;;;;;;;;;;;;;;CCC......CCC;;;;EEEEEEEEEEEEEEEEEE
DDDDDDDDDDDDDDDDDDDD;;;;CCCCCCCC;;;;;;;;;;;;;;;;;;;;;;;;HHHHHHHHHHHHH..H;;;;;;;;;;;;;;;;;;;;;;;.CCCCCCCC;;;;EEEEEEEEEEEEEEEEEEEE
DDDDDDDDDDDDDDDDDDDDDD;;;;;;;;CC;;;;;;;;;;;;;;;;;.;;;;;;..HHHHHHHHHHHH..;;;;;;;;;;;;;;;;;;;;;;;;CC;;;;;;;;EEEEEEEEEEEEEEEEEEEEEE
DDDDDDDDDDDDDDDDDDDDDDDD;;;;;;;;;;;;;;;;;;;;;;;;;;;;;;;;H..HHHHHHHHHHHHH;;;;;;;;;;;;;;;;;;;;;;;;;;;;;;;;EEEEEEEEEEEEEEEEEEEEEEEE
DDDDDDDDDDDDDDDDDDDDDDDDDDDDDD;;;;;;;;;;;;;;;;;;;;;;;;;;HHHHHHHHHHHHHHHH;;;;;;;;;;;;;;;;;;;;;;;;;;EEEEEEEEEEEEEEEEEEEEEEEEEEEEEE
DDDDDDDDDDDDDDDDDDDDDDDDDDDDDD;;;;;;;;;;;;;;;;;;;;;;;;;;HHHHHHHHHHHHHHHH;;;;;;;;;;;;;;;;;;;;;;;;;;EEEEEEEEEEEEEEEEEEEEEEEEEEEEEE
DD..DDDDDDDDDDDDDDDDDDDDDDDDDD;;;;;;;;;;;;;;;;;;;;;;;;;;;;HHHHHHHHHHHH;;;;;;;;;;;;;;;;;;;;;;;;;;;;EEEEEEEEEEEEEEEEEEEEEEEEEE..EE
DD..DDDDDDDDDDDDDDDDDDDDDDDDDDDD;;;;;;;;;;;;;;;;;;;;;;;;;;HHHHHHHHHHHH;;;;;;;;;;;;;;;;;;;;;;;;;;EEEEEEEEEEEEEEEEEEEEEEEEEEEE..EE
D..DDDDDDDDDDDDDDDDDDDDDDDDDDDDD;;;;;;;;;;;;;;;;;;;;;;;;;;HHHHHHHHHHHH;;;;;;;;;;;;;;;;;;;;;;;;;;EEEEEEEEEEEEEEEEEEEEEEEEEEEEE..E
DDDDDDDDDDDDDDDDDDDDDDDDDDDDDDDD;;;;;;;;;;;;;;;;;;;;;;;;;;HHHHHHHHHHHH;;;;;;;;;;;;;;;;;;;;;;;;;;EEEEEEEEEEEEEEEEEEEEEEEEEEEEE..E
D..DDDDDDDDDDDDDDDDDDDDDDDDDDDDD;;;;;;;;;;;;;;;;;;;;;;;;;;;;;;;;;;;;;;;;;;;;;;;;;;;;;;;;;;;;;;;;EEEEEEEEEEEEEEEEEEEEEEEEEEEEEEEE
DD..DDDDDDDDDDDDDDDDDDDDDDDDDDDD;;;;;;;;;;;;;;;;;;;;;;;;;;;;;;;;;;;;;;;;;;;;;;;;;;;;;;;;;;;;;;;;EEEEEEEEEEEEEEEEEEEEEEEEEEEEE..E
D..DDDDDDDDDDDDDDDDDDDDDDDDDDDDDDD;;;;.;;;;;;;;;;;;;;;;;;;;;;;;;;;;;;;;;;;;;;;;;;;;;;;;;;;;;;;EEEEEEEEEEEEEEEEEEEEEEEEEEEEEE..EE
D..DDDDDDDDDDDDDDDDDDDDDDDDDDDDDDD;;;;;;;;;;;;;;;;;;;;;;;;;;;;;;;;;;;;;;;;;;;;;;;;;;;;;;;;;;;;EEEEEEEEEEEEEEEEEEEEEEEEEEEEEEE..E
DD..DDDDDDDDDDDDDDDDDDDDDDDDDDDD;;;;;;;;;;;;;;;;;;;;;;;;;;;;;;;;;;;;;;;;;;;;;;;;;;;;;;;;;;;;;;;;EEEEEEEEEEEEEEEEEEEEEEEEEEEE..EE
DDDDDDD....DDDDDDDDDDDDDDDDDDDDD;;;;;;;;;;;;;;;;;;;;;;;;;;;;;;;;;;;;;;;;;;;;;;;;;;;;;;;;;;;;;;;;EEEEEEEEEEEEEEEEEEEEE....EEEEEEE
DDDDDDD....DDDDDDDDDDDDDDDDDDDDD;;;;;;;;;;;;;;;;;;;;;;;;;;;;;;;;;;;;;;;;;;;;;;;;;;;;;;;;;;;;;;;;EEEEEEEEEEEEEEEEEEEEE....EEEEEEE
DDDDDDDDDDDDDDDDDDDDDDDDDDDDDD;;;;;;;;;;;;;;;;;;;;;;;;;;;;;;;;;;;;;;;;;;;;;;;;;;;;;;;;;;;;;;;;;;;;EEEEEEEEEEEEEEEEEEEEEEEEEEEEEE
DDDDDDDDDDDDDDDDDDDDDDDDDDDDDD;;;;;;;;;;;;;;;;;;;;;;;;;;;;;;;;;;;;;;;;;;;;;;;;;;;;;;;;;;;;;;;;;;;;EEEEEEEEEEEEEEEEEEEEEEEEEEEEEE
DDDDDDDDDDDDDDDDDDDDDDDDDDDDDDDD;;;;;;;;;;;;;;;;;;;;;;;;;;;;;;;;;;;;;;;;;;;;;;;;;;;;;;;;;;;;;;;;EEEEEEEEEEEEEEEEEEEEEEEEEEEEEEEE
;;;;;DDDDDDDDDDDDDDDDDDDDDDDDDDD;;;;;;;;;;;;;;;;;;;;;;;;;;;;;;;;;;;;;;;;;;;;;;;;;;;;;;;;;;;;;;EEEEEEEEEEEEEEEEEEEEEEEEEEEEE;;;;;
;;;;;;;;;;;;;;;;;;;;;;;;;;;;;;;;;;;;;;;;;;;;;;;;;;;;;;;;;;;;;;;;;;;;;;;;;;;;;;;;;;;;;;;;;;;;;;;;;;;;;;;;;;;;;;;;;;;;;;;;;;;;;;;;
